Nb de leçons divergente entre l'édition et G1 :2206		
		
ajout		
150		
Pourcentage : 6.799637352674524		
Lemme 	leçon	
fist il	Adont fist il (G1)	1
fu	Aprés fu (G1)	1
vit qe	Car quant li emperieres oï ce que (G1)	1
car	Et bien sachiez que (G1)	1
Et	Et quant (G1)	4
Saces	Et saches (G1)	1
Seinz Ambroses	Et saint Ambroise (G1)	1
Si	Et si (G1)	2
Et	Et tout (G1)	1
Il escoust	Il escoust, fait il, (G1)	1
Mes	Mes bien sachiez qu' (G1)	1
Seinz Martins	Mes saint Martin (G1)	1
Sires	Sires que tu aoures (G1)	1
a destruire	a confraindre l'ymage aus faus diex (G1)	1
la	a la (G1)	2
a vraie creance	a vraie foi et a veraie creance (G1)	1
ala	ala il (G1)	1
alumee	alumee et arse (G1)	1
si firent	aprés li fist on un (G1)	1
arcevesqes	arcevesques estoit (G1)	1
rasamblees	assemblees et requises (G1)	1
au povre home	au povre et cele partie meïsme (G1)	1
bon l'assomement	bien estre sens et sauvemenz (G1)	1
pastor	bon paistres (G1)	1
venoit	ce venoit (G1)	1
vint	ce vint (C2 G1)	1
vraiement	ceste chose et sanz doutance (G1)	1
cil	cil estoit (G1)	1
Ce	cist plors et ceste plainte (G1)	1
demanda	conmanda qu'il li deïssent (G1)	1
conmença	conmença molt durement (G1)	1
conté	conté et dit (G1)	2
couchierent	couchierent en sa ciaulle (G1)	1
covint	couvint il (G1)	1
chose	creature. Une foiz et autre li demanda s'il ooit neïs ne	
                entendoit nule chose (G1)	1	
croi je	croi je veraiement (G1)	1
de bone loy et de seinte vie	de bonne foi et de bonne loi et de sainte vie (G1)	1
de ceste vie	de ceste vie que ce seroit bien afaire (G1)	1
de	de la cité de la cité de (G1)	1
delivrez	delivrez par saint Martin (G1)	1
des siecles	des siecles sanz fin (C2 G1)	1
devant	devant lui (G1)	1
croire	dire ne reconter (G1)	1
el cors	el cors de celi sergent (G1)	1
enfermetez	enfermetez qu'il avoient (G1)	1
voiseus	envieus ne malicieus (G1)	1
envoia	envoia tantost (G1)	1
meüs en pitié	esmeüz durement pour le duel que li desciple menoient	
                entr'euls (G1)	1	
archevesqes 	estre arcevesques (G1)	1
seoir et gesir	estre plus coiement et bele noeve chambre (G1)	1
com seint Martin	et aornez de si bonnes mors conme saint Martin (G1)	1
car	et bien sachiez qu' (G1)	1
ou eglyse	et chastiaus et eglises (G1)	1
toz	et devant les sainz homes qui la estoient assemblé (G1)	1
et 	et la vint (G1)	1
qant	et qant (C2 C3 G1)	1
si	et si (G1)	9
flamber	faire grant flambe (G1)	1
fist	fist il (G1)	1
cuidance	fole quidance (G1)	1
fouc	fouc d'oeilles (G1)	1
esteinte	fu estrainte (G1)	1
sanez	gariz et sanez (G1)	1
genz	genz sarrazines (G1)	1
fiance	grant fiance (G1)	1
haste	grant haste (G1)	1
peor	grant paour (G1)	1
humles	humbles estoit (G1)	1
l'ame	l'ame du saint home (G1)	1
une grant tençon	la contençon granz et une discencion (G1)	1
lor compaignie	la cruels compaignie (G1)	1
li priast	la feïst et qu'il le proiast (G1)	1
ou	la ou (G1)	1
le grant chemin plenier	le grant chemin plenier et la grant voie batue (G1)	1
les genz	le pueple et les genz (G1)	1
le seint home	le saint home maint jour (G1)	1
desfendera	les desfendera (G1)	1
les nuz	les nuz qui povreté destraignoit et besoinz (G1)	1
les oevres et  les vies es escripturesescriptures	les vies et les oeuvres et les escriptures (G1)	1
disoit	leur disoit (G1)	1
lessast	leur lessast (G1)	1
removoir nena amont treire	lever ne remouvoir ne amont traire (G1)	1
toutes les forces de ses membres li conmencierent a faillirdeffaillir	li conmencierent tuit li membre a desfaillir et a	
                afebloier (G1)	1	
li cors	li cors saint (G1)	1
disoit	li disoit (G1)	1
vint pluisors foiz a seint		
                  Martin	li disoit souventes foiz a haute voiz cruels paroles a	
                saint Martin et (G1)	1	
issi	li issi (G1)	1
meint	maint biau (G1)	1
manoient	manoient et habitoient (G1)	1
sivoient. et chaçoient	mengoient et gaitoient en un lieu (G1)	1
meüst	meüst en nule maniere (G1)	1
formee	molt formé (G1)	1
granz	molt grant (G1)	1
granz loenges	molt grant loenge (G1)	1
looient	molt looient (G1)	1
moroit	moroit et qu'il ne rendoit l'ame (G1)	1
mort	mort et passion (G1)	1
malvestié	nule mauviestié (G1)	1
por retenir et oïr	pour oïr et retenir de (G1)	1
proia	proia il (C3 G1)	1
molt	puis molt (G1)	1
Li moigne qi estoient deciple	qu'il estoit granz a desmesure et de grant hautece. Li	
                pueples qui i estoit avoit grant paor de son trembler. (G1)	1	
el ciel	qu'il l'enportent la sus el ciel (G1)	1
de cui tous li  biens vientli biens toz viennent en terre et el ciel lassus	qui Sires est de toute creature, car de lui vient touz les	
                biens (G1)	1	
de l'eglisse	qui en l'eglise estoient (G1)	1
ses peres	qui ses peres estoit (G1)	1
por le seint hom s'aparut ilueqes	s'apparut pour le saint home ilec voiant touz cels qui y	
                estoient (G1)	1	
s'aprochierent	s'aprochierent tuit (G1)	1
sa volenté	sa volenté de maintes choses (G1)	1
sachiez bien	sachez bien cil qui ce demandez (G1)	1
cius	sains ciels (G1)	1
par sa seinte parole	saint Martin par saintes paroles et puissanz (G1)	1
sarqu	saint sarqueul (G1)	1
orisons	ses orisons (G1)	1
toz ses membres	ses plaies et ses menbres (G1)	1
seüst	seüst il (C2 C3 G1)	1
grant	si grant (G1)	1
auctorité	si grant auctorité (G1)	1
croire son seint home	son saintisme non croire et l'ome qui a lui parloit  (G1)	1
chaut	tout chaut (G1)	1
ensanglenté	tout ensanglenté en tel maniere (G1)	1
l'oevre	toute l'uevre (G1)	1
toute sanglante	toute sanglente. Dont moustra au saint home sa main et son	
                braz tout sanglent (G1)	1	
les	toutes les (G1)	1
toz les pechiez	toutes les choses et les pechiez (G1)	1
cels	touz cels (G1)	2
toz	touz celz qui la estoient (G1)	1
les	touz les (G1)	1
li ans	touz li anz (G1)	1
puissanz	touz puissanz (G1)	1
li prestre	tuit li prestre (G1)	1
valu	valu et conforté (G1)	1
venoient	venoient ne les pooit souffrir en nule maniere (G1)	1
vie	vie mener (G1)	1
volentiers	volentiers sacrefices et (G1)	1
		
inv.		
122		
Pourcentage : 5.5303717135086129		
Lemme 	leçon	
.ii. angeles	angeles .ii. (G1)	1
s'en revint adonc	Adonc s'en vint (G1)	1
Tuit estoient	Ainz estoient tuit (G1)	1
Beaus signors de Poitiers, se vos	Se vous biaus seignors de Poitiers (G1)	1
adonqes en cel tens	a cel tans adonc (G1)	1
a venir envers  lui et a cheïr	a cheoir et a venir envers lui (G1)	1
a douner et a departir	a departir et a donner (C2 C3 G1)	1
de cheïr fere samblant	a faire semblant de chaoir (G1)	1
en escripture a metre	a metre en escripture (G1)	1
son cuer a nostre Signor	a nostre seigneur son cuer (G1)	1
a ses freres a proier	a proier ses freres (G1)	1
graces a rendre	a rendre graces (G1)	1
li desfendoient a trenchier	a trenchier le desfendoient (G1)	1
arrester et aguetier	agaitier et arester (G1)	1
le deable einsi parler	ainsi parler le deable (G1)	1
celui einsi	ainssi celui (G1)	1
a terre ambedui	ambedui a terre (G1)	1
.ii. angeles	angeles .ii. (G1)	1
creoit et aoroit	aouroit et creoit (G1)	1
a la premiere foiz auroit la victoire	aroit a la premiere foiz victoire (G1)	1
la coupe baillié au prestre	au prestre la coupe baillie (G1)	1
dire au seint home	au saint home dire (G1)	1
ceste parole autre foiz	autre foiz ceste parole (G1)	1
devoient avenir	avenir devoient (G1)	1
petit avoir fait	avoir petit fait (G1)	1
ceste chose avoit oïe	avoit ceste chose oïe (G1)	1
devant avoit	avoit devant (G1)	1
un pou de ses vesteüres avoient	avoit un poi de sa vesteüre (G1)	1
receü baptesme	bapteme receü (G1)	1
receü baptesme	baptesme receü (G1)	1
sacré et beneï	beneï et sacré (G1)	1
sacree et beneïe	beneïe et sacree (G1)	1
molt volentiers celui	celui molt volentiers (G1)	1
savoir certeinnement	certainement savoir (G1)	1
grant chaleur	chaleur grant (G1)	1
les deables chaçoit	chassoit les deables (G1)	1
venist et cheïst	chaïst et venist (G1)	1
fu mout dolenz, si conmença a plo--rer	conmença a plorer et fu molt dolanz (G1)	1
oster de la ou il estoit enfoïz	de la ou il estoit enfouiz oster (G1)	1
cele grant mervelle de loing	de loinz cele merveille (G1)	1
puissance de lui traveillier	de lui travaillier puissance (G1)	1
de doçor et de repoz	de repos et de douceur (G1)	1
ensegnast et demostrast	demoustrast et enseignast (G1)	1
l'autel despechier et desfere	depecier et desfaire l'autel (G1)	1
a celui qe j'ai		
                conté dessamblables	dessemblables a celui que j'ai devant dit (G1)	1
aler devoit	devoit aler (G1)	1
a ses freres conté et dit	dit as ses freres et conté (G1)	1
cuidié et dit	dit et cuidié (G1)	1
fu ele	ele fu (C2 G1)	1
les deables chacier fors	enchacier les deables (G1)	1
mie encore	encore mie (C2 C3 G1)	1
ceste vie entendent	entendent ceste vie (G1)	1
en orissons envers nostre Signor	envers nostre seigneur en oroisons (G1)	1
confermé de ses beneïçons. et esleeciez de ses beles		
                    vertuz. et de ses granz miracles	esleecié de ses beles vertuz et de ses granz miracles et	
                  si avez esté confremé de ses beneïçons (G1)	1	
poissanz est	est puissanz (G1)	1
en cel tens estoient	estoient en ce tans (G1)	1
cheve estoit	estoit cavee (G1)	1
en tel liu estoit	estoit en tel lieu (G1)	1
en sa compaignie estoit venuz	estoit venuz en sa compaignie (G1)	1
vestuz estoit	estoit vestuz (G1)	1
tant esté	esté tant (G1)	1
et de par mere et de par pere	et de par pere et de par mere (G1)	1
estoit seinz Martins	et que saint Martin estoit (G1)	1
et a ceste covenence se  tindrent bien	et si se tindent bien a cest couvenance (G1)	1
voisins evesqes	evesqes voisins (C2 C3 G1)	1
demostrer et fere	faire et demoustrer (G1)	1
grant noise et grant fremissement	grant fremissement et molt grant noise (G1)	1
hauz hom	hom haus (G1)	1
est il	il est (G1)	1
oï il	il oï (G1)	1
il avoient geuné	jeuné avoient (G1)	1
devant l'empereor tenoit la coupe d'or	la coupe d'or tenoit devant l'empereor (G1)	1
de la cité  et de la contree d'environ i estoient assamblétuit assemblez	la estoient assemblé de la cité et de la contree	
                environ (G1)	1	
la crestiene loy	la loi crestiene (G1)	1
ester le diable	le deable ester (G1)	1
trova bien et prova	le prouva bien et trouva (G1)	1
les iols et les meins	les meins et les euz (C2 C3 G1)	1
deguerpissoient et leissoient	lessoient et guerpissoient (G1)	1
et deguerpi le baptesme	leur baptesme et deguerpi (G1)	1
a nostre Signor lor orissons	leur oroisons a nostre Seigneur (G1)	1
a reprendre lor valors	leur valeur a reprendre (G1)	1
li deables par son art deceü	li deables deceü par son art (G1)	1
ce oï li seinz hom	li sainz hom oï ce (G1)	1
hauça li uns	li uns hauça (G1)	1
avoit molt	molt avoit (G1)	1
mout dolenz et molt corrociez	molt coureciez et molt dolant (G1)	1
et dist soudeinement	molt soudainement et dist (G1)	1
arriere mout tost	molt tost arriere (G1)	1
molt 		
              esmaie et torblee	molt troublee et esmeüe (G1)	1
grant chose est	mout est grant chose (G1)	1
devant nomé	nomé devant (G1)	1
tout en tot nostre Signor	nostre seigneur del tout en tout (G1)	1
n'avoient onqes	onqes n'avoient (G1)	1
a peines ose	oz a paine (G1)	1
travail et paine	paine et travail (G1)	1
conter par autrui	par autres conter (G1)	1
celtel temple depecier par sa force	par force cel temple despecier (G1)	1
li fu la parole rendue		
                par la volenté de nostre Signor	par la volenté de nostre Seigneur li fu la parole	
                rendue (G1)	1	
le seint home par paroles	par parole le saint home (G1)	1
precieuses pierres	pierres precieuses (G1)	1
par les meins des seinz angeles portez	portez par les mains des sainz angles (G1)	1
a son oés: por demorer	pour demorer a son oés (G1)	1
la ou il ert en presence por lui	pour lui la ou il estoit en presence (G1)	1
au seint home por reqerrepor le reqerre	pour requerre au saint home (G1)	1
example prendre	prendre essample de bien (G1)	1
sesir. et prendre	prendre et saisir (G1)	1
seinz homes et prodomes	preudomes et sainz (G1)	1
li evesqes puis	puis li evesques (G1)	1
Li empereres, qant il oï ce, 	qant ce oï li emperieres (G1)	1
qe lendemein l'emporteroient il a		
                force	qu'il l'emporteroient lendemain par force (G1)	1
s'afichierent et distrent bien	s'afichierent bien et distrent (G1)	1
preudom: et seinz hom	saint hom et preudom (G1)	1
descendoient sor la meson	seur la maison descendoient (G1)	1
mout durement: sor une meson	seur une maison molt durement (G1)	1
la char de li est	si est la char de lui (G1)	1
a vos soffire	souffire a vous (G1)	1
ancien temple	temple ancien (G1)	1
estoient en communité mises totes lor choses	toutes leur choses estoient mises en communité (G1)	1
arrierea terre toz estenduz	touz estenduz arriere (G1)	1
toz combrisiez et maumis	touz maumis et touz conbrisiez (G1)	1
fet fere un autel	un autel fet fere (G1)	1
en la cité venuz	venuz en la cité (G1)	1
qi en avoit grant doel et grant ire vint a lui 	vint avant qui avoit grant duel et grant ire (G1)	1
		
plur.		
10		
Pourcentage : 0.4533091568449683		
Lemme 	leçon	
autel	autelz (G1)	1
avoit	avoient (G1)	1
destruisoit	destruisoient (G1)	1
fist	firent (G1)	1
fors de la porte	fors des portes (G1)	1
fust	fussent (G1)	1
grant segnorie	granz seignories (G1)	1
la chose	les choses (G1)	1
la lumiere receüe	les lumieres receües (G1)	1
sa proiere	ses proieres (G1)	1
		
red.		
35		
Pourcentage : 1.5865820489573889		
Lemme 	leçon	
et il fist sor lui le signe de la croiz. et 	Il se leva et fist (G1)	1
del tout en	a (G1)	1
d'aler ensamble o lui estoient		
                adés acostumé	aloient avec lui (G1)	1
qi archevesqes estoit de Tors	archevesque de Tors (G1)	1
ensamble o la seinte compaignie de ses deciples	atout ses desciples (G1)	1
la chose avenue	avenu (G1)	1
ester de chose q'il nos vousist feire, car il es--toit		
                de si grant auctorité: qe ce me		
                semblast vilenie		
                et pechiés, se je li		
                escondeïsse ne ne sousfrisse chose q'il me		
                vousist fere	ce qu'il voloit aler (G1)	1
les pluseurs genz vindrent	cil (G1)	1
l'agaitoit et destraignoit	contralioit (G1)	1
del seint	de (G1)	1
qi de Poitiers estoient	de Poitiers (G1)	1
qi de Tors estoient	de Tors (G1)	1
qi estoient as	des (G1)	1
donoit tout as povres	donnoit as povres (C2 G1)	1
il en tel maniere	en tel maniere (G1)	1
establissoit il et faisoit	establissoient (G1)	1
ou il li	et (G1)	1
ensamble o la conpagnie des seintes virges	et avec les vierges (G1)	1
et par griez tormenz: et par veilles		
                et par geunes	et par martire (G1)	1
qi mengoient les poissons et les devoroient	et qui les poissons devouroient (G1)	1
nule folie	felonnie (G1)	1
pot mal feire ne grever	fist mal (G1)	1
molt grant froidure	froit (G1)	1
joste lui: cui il voloit		
                honorer et grant feste fere. Et 	honorez (G1)	1
les griez peines	la paine (G1)	1
mie cil qi fust si	pas (G1)	1
si en voudrent porter	por (G1)	1
joste le fu firent il un beaumolt biau lit de fuere a oés l'evesqe	puis un haut lit conme a evesque (G1)	1
s'esmerveillierent de la grant		
                vertu qe nostre Sires avoit mise en seint Martin, qeqi sor oiseaus meïsmes avoit de conmander		
                puissance	s'en merveilloient mout (G1)	1
sa grant douçor et par		
                sa grant misericorde	sa bonté (G1)	1
entendoit bien et savoit	savoit bien (G1)	1
fermeüre desfermer del huis	serrure desfremer (G1)	1
Tout ausi	si (G1)	1
lassez et ennuiez de si longe demorance	touz lassez de la demorance (G1)	1
deüst venir	venist (G1)	1
		
sing.		
18		
Pourcentage : 0.8159564823209429		
Lemme 	leçon	
ce sont cil	c'est ceus (G1)	1
descendissent	descendist (G1)	1
estoient	estoit (G1)	2
eüssent	eüst (G1)	2
forces	force (G1)	1
granz miracles et granz merveilles	grant miracle et grant merveille (G1)	1
granz vertuz	grant vertu (G1)	1
guetent	guete (C2 C3 G1)	1
les empereors	l'empereor (C2 G1)	1
les compaignies	la compaingnie (G1)	1
les flambes	la flambe (G1)	1
les torbes	la torbe (G1)	1
prestres	prestre (G1)	1
mie autre mal qe feïssent	riens plus mal que feïst (G1)	1
s'asamblerent	s'asembla (G1)	1
totes choses	toute creature (G1)	1
		
temps		
33		
Pourcentage : 1.4959202175883953		
Lemme 	leçon	
avoient aoré	aoroient (G1)	1
apertienent	apartenoient (G1)	1
eüst	avoit (G1)	1
estoit	avoit esté (G1)	1
proia li empereres	avoit li emperieres proié (G1)	1
c'est	c'estoit (G1)	1
cremirai	criem (G1)	1
crierent	crioient (G1)	1
deümes	devons (G1)	1
distrent	disoient (G1)	1
dist	disoit (G1)	1
devroient	doivent (G1)	1
estoit	est dit (G1)	1
fust	estoit (G1)	2
feïst	faisoit (G1)	1
feisoient	font (G1)	1
gardoit	garde (G1)	1
gardent	gardoient (G1)	1
greveroit	grevast (G1)	1
lessoient	lessierent (G1)	1
m'esvellastes	m'avez esveillié (G1)	1
avoient	ont (G1)	1
oï	ot oïes (G1)	1
peüst	poist (G1)	1
cuidoient	quidierent (G1)	1
ert	sera (G1)	1
sera	soit (G1)	2
est trespassee	trespasse (G1)	1
vient	vint (G1)	1
vout	voloit (C3 G1)	1
voloit	volt (G1)	1
		
om.		
572		
Pourcentage : 25.929283771532185		
Lemme 		
 ne leçon	1	
Adonc et 	1	
Aprés qant totes cez voiz	1	
ce	1	
Ce est a dire	1	
Ce est certeinecerte chose et provee	1	
Ce puet l'en veoir	1	
Dont cil serront mat et confus. Qi bien servi ne l'averontauront.  Et cil qi ses comansconmandemenz feront. Averontauront joietel joie et tel leesche,  Tel signorie et tel hautesce Qe nus deviser nel sauroit, Ja tant ne s'en entremetroit Riches,		
                      povres conmunement. Qi a cel esjoïssement. Peüssent venir sanz desfense. Et cil qi la venir ne pense. Est certes en molt male voie,  Car li deables le desvoie. Qi oa lui est soir et matin. Qi la vie ot de seint		
                      Martin, Aucun bien en doit retenir,  Car del bien doit bien sovenir. Le mal doit l'en lessier aler. Ce oi sovent dire et conter. Qe del bien doit nestre li biens,  Del mal le mal as ancïens. Ne vos en sai plus qe retraire. BuerBien fu nés qi le bien puet feire,  Car Dex l'aime, mon essïent. Qant li emperere oet sa gent. 	1	
et	1	
Et	19	
Et por  ce	1	
Et qant il vint premiers a Conde: et 	1	
Et tout	1	
le saint home	1	
Mes	1	
Miracles de seint Martin	1	
ne	1	
Qi del trestottot nos assegure. Et qi la verité en dist, 	1	
Qi sa vie nos a retrete. El latin qi molt bien l'a fete. Au tiesmoing ceus qi l'ont leüe. Et tote oïe et entendue.	1	
Seinz		
                  Martins	1	
Si com il ardi un templeun temple de paiens	1	
Si com il cheï del cenailldou cheval	1	
Si com il delivra le serjant au conselle	1	
Si com il rendi a un home son oel 	1	
Si com seinz Martins resuscita un		
              mort	1	
Si com il chaça le deable hors d'une		
              meson	1	
si dist	1	
Toz	1	
Un autre miracle	2	
Une	1	
Uns autres miracles	1	
Uns autres miracles	1	
Uns miracles de seint Martin	1	
a	4	
Aies merci de nous qe tu ne nos deguerpisses mie	1	
adonc	1	
adonqes	1	
adonques	1	
aet a grant joie	1	
amont	1	
amor	1	
apelé	1	
as povres	1	
as freres	1	
as iols	1	
as malades	1	
aucuns	1	
autre chose	1	
autre chose. ne	1	
autres	1	
a ceste chose	1	
a crier	1	
a depecier	1	
a dire	1	
a feire et a dire	1	
a ferir	1	
a l'arcedyacre	1	
a l'arcedyacre	1	
a l'empereor	1	
a la table seoit et 	1	
a lui	2	
a nos	1	
bien	4	
c'on i veoit	1	
Car chascuns veut trestot avoir. Et chascuns tient a grant savoir. Que la ou doit doner souvent. Doinst a chascun pou ou noient. Mes je vous di que mal esploite. Qui tout a retenir couvoite, Car morir couvient en la fin. Qui souvendroit de seint		
                      Martin. Et qui ses voies ensivroit. Ja certes avers ne serroit. Ne n'auroit en lui felonie. Ne mauvestié ne vilonie. Si en devroit bien sovenir: A tous ceus qui cuident morir. Mes autres ne le dient mie. Qi la mort tienent a folie. Ne qui ne cuident ja finir. Ne de cestce siecle departir. 	1	
ce	5	
ce est de ses deciples qi ensamble o lui erent	1	
ce estoit por	1	
ce qu'il  portoient	1	
cele mellee	1	
cest ver del Sautier	1	
cil	1	
coiz	1	
com il li vint devant, si	1	
comencierent	1	
com il	1	
cruele	1	
d'	1	
d'eus	1	
De .seint. Martin	1	
de	8	
de Uns autres miracles tens	1	
de ceste vie	1	
de la	1	
de lor oevres	1	
del cors	1	
devant	3	
devers	1	
de grant maniere	1	
de la contree	1	
de la terre	1	
de la grant torbe dedes paiens	1	
de noient	1	
de Rome	1	
de Tors	2	
de par nostre Signor	1	
dit et 	2	
dites et 	1	
dont	1	
droit	1	
Dominus michi adjutoradjutoz est, non timebo quid faciat michi		
                    homo	1	
einz	1	
en	13	
en compaignie	1	
en la cité	1	
en lor compaignie	1	
en meïsmes l'eure	1	
en nule maniere. ne geter		
                fors	1	
en plorant	1	
en sa conpaignie	1	
en son leu	1	
encore	3	
enmi	1	
ensamble	2	
ensamble o lui	1	
entr'eus	1	
entre eus	1	
entresait	1	
envers nos	1	
en croiz	1	
en estant	1	
en lui	1	
en nule maniere	2	
en tel maniere	1	
estoient	1	
et	2	
et grant derverie	1	
evesque	1	
eüe	1	
feire	1	
fere	1	
fors	2	
fu	2	
grant	7	
haute	1	
hom	1	
i	10	
Jesu Crist	1	
Jesu Criz	1	
ja	2	
je	1	
il	17	
il ne li voloient mie	1	
il li noncierent q'	1	
issu	1	
i estoient oïez	1	
l'	2	
l'amor	1	
l'en	1	
l'oevre de	1	
la	9	
la coupe	1	
la terre	1	
la chose	1	
le	3	
le jor	1	
le seint home	1	
leesche	1	
les	4	
leur	1	
le boneüré evesqe	1	
li	9	
li conceles	1	
li empereres	1	
li evesqes	1	
li seinz hom	1	
li seinz	1	
li arcevesqes	1	
li arcevesqes et li arcedyacres	1	
li seinz hom	1	
li seinz hom	1	
longue parole	1	
lor	1	
me	1	
meintenant en	1	
meïsme	3	
meïsmes	3	
mes	2	
mis	1	
mis por esgarder	1	
molt	6	
molt ancien	1	
molt doucement	1	
mon signeur	2	
mortel	1	
mout	5	
mout haut	1	
mout proçaine	1	
n'	1	
n'autre rien	1	
n'i	1	
Ne onqes	1	
ne	4	
ne ne troublez	1	
ne se pooit	1	
ne tant ne qant	1	
nos	1	
nostre Signor	1	
nule	1	
ore	1	
ouel temple	1	
Puis	1	
par	1	
par grant amor et par  grant diligense	1	
par grant ire	1	
par la volenté de Deu le temple aidié a destruirele temple a destruire	1	
par sa doçor et par sa misericorde	1	
plenierement	1	
pluiseurs	1	
plus	2	
por	2	
por aler encontre celui	1	
por euz	1	
por feire lor orissons ensamble	1	
por la grant clarté et 	1	
porter	1	
puis	1	
q'	1	
q'a cele hore tout droit	1	
q'il	1	
q'il avoient eü	1	
q'il avoit faite	1	
q'il comportoient	1	
q'il li covenoit a fere	1	
qant	1	
qe	4	
qe tu t'en repentisses	1	
qe ce vint a unau jor	1	
qi	3	
qi ce virent	1	
qi chantoient	1	
qi descordé  estoient	1	
qi en son mostier estoient	1	
qi ensamble o lui estoient	1	
qi en  la contree estoient	1	
qi la estoit venue	1	
qi venoit	1	
resplendissant	1	
s'	2	
sa	1	
se	4	
se departisist de la et 	1	
seculer	1	
seint	3	
seinte	3	
seinz	5	
seroit molt	1	
servir	1	
ses	1	
seul	1	
seulement	1	
seint	1	
si	44	
si com vos poez veoir,		
                    si m'a tolue la vie	1	
si come  chevaliers	1	
si ert soudainement morz	1	
sieme an	1	
si com droiz estoit. 	1	
si gieterent le saint home d'enmi le feu hors. ou il estoit en orisons	1	
si li	2	
si tost	1	
sor un pavement tenvene qi en cele chambre estoit	1	
sour granz chevaus. richement		
                coverz de molt beles covertures	1	
tant	1	
tant qe l'en peüst avoir alé	1	
tantost q'tantost comil ot beü	1	
tost	1	
tost et isnielement	1	
tot	1	
tot a sa devise	1	
tout	3	
tout premiers	1	
toz	2	
tres	1	
tuit	4	
un pou loing	1	
voie meïsmes	1	
vos	3	
Et	2	
Et 	2	
Et si la emplist einsi com il avoit entrepris		
                a fere	1	
conment il ert apelez: et si li dist	1	
et 	32	
et  aemplissoit	1	
et as voies	1	
et a amonester	1	
et a la vraie creance	1	
et a tel costume	1	
et a tenir	1	
et besoigneus estoient	1	
et bone volenté	1	
et ce dire	1	
et ceste oevre	1	
et cheï	1	
et com	1	
et contes	1	
et crurent	1	
et de dire	1	
et de lié	1	
et dit	1	
et doivent	1	
et droit	1	
et en vegiles	1	
et entendi	1	
et entendirent	1	
et entendoit	2	
et esmervelloient	1	
et esperdu	1	
et fors de doutance	1	
et la joie	1	
et li evesqe. et 	1	
et lor habitations	1	
et menjoient	1	
et molt religieuse	1	
et mout bien atornee	1	
et mout tristre	1	
et por les granz torbes	1	
et pris	1	
et sanz doutance	1	
et sanz droiture	1	
et sauvee	1	
et si li dist	1	
et si disoient 	1	
et si li dist	1	
et tante proiere fete	1	
et tolue la vie	1	
et tramise	1	
et une grant dissention	1	
et consomee	1	
et par tel covenance	1	
partie	1	
par cui nostre Sires feïst les signes	1	
par l'aïde del viel home, si l'emporterent	1	
par le palés trestoz	1	
par lui	1	
		
Leçons d'ordre sémantique (1266)		
Pourcentage : 57.3889392565729828		
Lemme 	Leçon	
de la contree de Pannone	en la citeé de Pannonie (G1)	1
hardiement seinz Martins	 saint Martin sanz paour et sanz doutance (G1)	1
.ii.	.iii. (G1)	2
et les seintes reliqes et les croiz		
                  et .vii. cierges i furent aportez tos ardanz	qui avoit aportees les croiz et les saintes reliques et .vii. cierges ardans (G1)	1
En	A (G1)	1
Et dont	Adonc (G1)	6
Anatolius	Anathaise (G1)	1
Aprés	Après ce (C3 G1)	1
Et aprés ce	Aprés ce mout petit (G1)	1
mout doit on  doucement et volentiers le bien oïr et entendre, car par le  bien savoir et retenir: puet l'en sovent a bien venir. Qui bien ne seit ne bien n'entent. de bien faire n'a  nul talent. Mes delde bien nest sovent li  biens, del mal li maus	Chascuns doit volentiers oïr le monté parliement et le bien entendre	
                qui puet venir de bones paroles, car par le bien savoir et retenir ne puet on		
                s'amender non. De bien nait bien et de mal li maux (G1)	1	
Si	Cil (G1)	1
nostre Signor	Dieu (G1)	1
Jesu Crist	Diex (G1)	1
Adonc	Dont (G1)	9
Endementieres	Entre ces choses (G1)	1
Si avoit ensamble o eus	Entreuls avoit (G1)	1
Dont	Et (G1)	2
Aprés	Et aprés (G1)	1
Si moigne et si deciple	Et en mi ses descriples et ses moines (G1)	1
Adonc	Et il (G1)	1
La	Et la (G1)	1
Et en cel leu ou	Et la ou (G1)	1
Li	Et li (G1)	1
Pluisors	Et li pluseur (G1)	1
Lors	Et lors (G1)	1
Tuit manoient	Et mengoient tuit (G1)	1
Et ne por qant en sa jovenece fu il si		
                ententis entor seinte yglisse: q'il i porpensa en s'enfance ce q'il aempli mout docement	Et nequedent il fu molt entendanz a sainte eglise et pourpensa tres	
                s'enfance ce qu'il aempli durement (G1)	1	
Par	Et par (G1)	1
Por	Et por (G1)	2
por	Et pour (G1)	1
Qant	Et qant (G1)	2
Qant	Et quant (G1)	4
Quant li seinz hom lor ot ce dit	Et quant il ot ce dit (G1)	1
tant	Et tant (G1)	1
Tantost	Et tantost (G1)	1
Tantost com seinz Martins	Et tantost com s'il (G1)	1
Tuit li home de la cité	Et tuit cil de la contree (G1)	1
Rufus	Faifus (G1)	1
Car il estoit plus blans qe leiz ne noiz negie	Il est plus purs et plus nez et plus blans que noif negiee (G1)	1
ne vos voel je	Je ne veul (G1)	1
Je sui  Crist	Je suis Jhesu Crist (G1)	1
Deu	Jhesu Crist (G1)	1
Jupiter	Jovis (G1)	1
Si com	La ou (G1)	11
n'autres orelliers ne autres lincieus	Li sainz hom n'avoit autres linceus ne autres oreilliers (G1)	1
Et	Lors (G1)	3
Tantost com	Maintenant qu' (G1)	1
Vangione	Mangione (G1)	1
Maximiens	Maximes (C3 G1)	2
N'onqes	Ne (G1)	1
O	Or (G1)	1
Par	Pour (G1)	1
Perpetuus	Propetuus (G1)	1
Et puis	Puis si (G1)	1
Et com	Quant (G1)	1
por ce q'il voloit qe l'en le		
                tenist en auctorité aussi com un prophete	Quant Anatholius oï et entendi que Clarus ne vouloit que l'en le tenist	
                en auctorité aussi conme un prophete (G1)	1	
Qant	Quant vint que (G1)	1
Rurtius	Rimarius (G1)	1
Son viaire	Saint Martin (G1)	1
Severus	Sevrins (G1)	1
Einsi	Si (G1)	4
Et ausint com	Si conme (G1)	1
si grant joie l'en crut	Si en ot si grant joie (G1)	1
et la celle fu raemplie de si grant		
                pueur qe	Si remest la ceaule toute empullentee (G1)	1
de tote chose est sires et crieres	Sires est de toute creature (G1)	1
Meintenant	Tantost (G1)	1
Toraine	Tours (G1)	1
Ysabbarie	Ysapharie (G1)	1
en	a (G1)	13
A ce regarderent	a ce pristrent garde (G1)	1
cels	a cels (G1)	1
a cele oevre s'	a ces oevres faire (G1)	1
combatre	a combatre moi en tele maniere comme cil autre font (G1)	1
a proier et a rover	a demander et a requerre (G1)	1
a estreindre	a estraindre l'une a l'autre (G1)	1
estoit aorez	a esté (G1)	1
faire	a faire (G1)	1
si com pluiseurs choses avienent	a jugement (G1)	1
encontre	a l'encontre (G1)	1
en la partie de la meson	a la porte (G1)	1
au a un home son		
                oel seint home	a li (G1)	1
nous en	a nous (G1)	1
Si prioit	a proier (G1)	1
ou	a qui (G1)	1
li seint non nostre Signeur Jesu Crist a anoncieranoncier le	a reclamer le non nostre seigneur (G1)	1
a table en sa compaignie	a sa table (G1)	1
au seint home	a saint Martin (G1)	1
as	a ses (G1)	1
veoir son pere et sa mere	a son pere et a sa mere (G1)	1
ensamble o	a toute (G1)	1
en un	a un (G1)	1
a veritables	a veritables non mie a fables (G1)	1
consomee	achevee (G1)	1
aemplir	acomplir (G1)	2
costume	acostumé (G1)	1
atargiez	acouchiez (G1)	1
uns deables toz tens	ades uns deables (G1)	1
dont	adonc (G1)	1
cil q'il avoitavoient encontrez	adonc leur feste (G1)	1
adolee	adoubee (G1)	1
lor deliz d'endroit	aese de (G1)	1
l'afubleüre ert laide	afublé estoit laidement (G1)	1
gaitoient	agaitoient (G1)	1
Et si	ainsi (G1)	1
et en abiten l'abit de moigne	ainz (G1)	4
devant ce qe	ainz que (G1)	1
ainz	ainçois (G1)	2
venist	alast (G1)	1
venir	aler (G1)	1
lui passoient	aloient (G1)	1
estoit alez un temple depecier	aloit aprés et estoit alez a un autre temple depecier (G1)	1
un vilein loé	aloué un home (G1)	1
l'amoient	amoient lui (G1)	1
a mostrer	amonnester (G1)	1
contremont	amont (G1)	1
lor arbre a trenchier mout liement. et a grant joie por abatre	amont grant joie l'arbre a abatre et a trebuschier (G1)	1
deables	anemis (G1)	1
orer	aouremenz faire iluec (G1)	1
apelez	apelez par nom (G1)	1
apelez	apelez par non (G1)	1
aportee	aportast (G1)	1
ne aprochier	aprimer (G1)	1
empriés	aprés (G1)	1
puis	aprés ce (G1)	1
grant	aprés lonc (G1)	1
qant il est morz	aprés sa mort (G1)	1
l'arcevesqes	archevesques (G1)	2
prist	arresta (G1)	1
demorer	arrester (G1)	1
arrester	arrester soi (G1)	1
encontre	arriere (G1)	1
ausint	assemblé (G1)	1
toucha	atoucha (G1)	1
et ensamble o soi	atout (G1)	2
del	au (G1)	3
a l'anemi	au deable (G1)	2
as meinz	au doit (G1)	1
plus	au plus (G1)	1
de seint Martin	au saint home (G1)	2
molt eüssentfeïssent bien al siecle lor volentez	au siecle eüssent molt de leur volentez (G1)	1
bien	aucun bien (G1)	1
trop granz maladie	aucune maladie (G1)	1
devorer et ocirre as denz	aus denz a erdre et devourer et ocirre (G1)	1
ses	autres (G1)	1
ensamble	avec (G1)	21
i entrerent aveuqesensemble	avec entrerent (G1)	1
en la compaignie au	avec le (G1)	2
ensamble	avec li (G1)	1
le sivirent	avec lui (G1)	1
grant partie ensamble o lui	avec lui grant partie (G1)	1
qi	avec qui (G1)	1
en cui compaignie il estoit venuz	avec qui il estoit venus en conpaignie (G1)	1
venir	avenir (G1)	1
avenoit	avenist chose (G1)	1
cez choses avez oïes qe j'ai		
                contees	avez ces choses escoutees et oïes (G1)	1
vindrent	avindrent (G1)	1
veoit	avoient (G1)	2
enfanz avoient: chevaliers les		
                feïssent.	avoient enfanz en feïssent toz chevaliers (G1)	1
avoient	avoient mis (G1)	1
estoit trespassé	avoit (G1)	4
si grant q'ele trespassoit tote l'umanité  de cest monde	avoit en lui (G1)	2
lonc tens avoit portee	avoit lonc tans eüe (G1)	1
estoit entrez el cors	avoit pris et saisi (G1)	1
comanderent	baillierent (G1)	1
sacrez a oés le deable et beneïz	beneïs et sacrez as deables (G1)	1
beneïs	beneïsses (G1)	1
besoignables a	besoigneus avec (G1)	1
bon exemple	biau miracle (G1)	1
hauz	biaus (G1)	1
beaus (#C2 #C3)	bien (G1)	1
deguerpir	bien deguerpir (G1)	1
seint	bon (G1)	1
. et douçour. et pitié. et 	bonne et loiaus (G1)	1
boidissant et	bruiant (G1)	1
il estoit	c'estoit (G1)	1
qe	car (G1)	1
oï	ce (G1)	6
si eüst il fait	ce eüst il fait ançois (G1)	1
de ce fu il mout dolenz	ce fist il molt dolanz (G1)	1
qe	ce que (G1)	1
il vint	ce vint (G1)	1
chaucemente	ceinture (G1)	1
ce	cel (G1)	1
ceste	cele (G1)	1
la citez	cels (G1)	1
ceaille	celulle (G1)	1
sanz doutance	certainement (G1)	1
creature reson	certaineté (G1)	1
portoient tieus noveles	ces nouvelles portoient (G1)	1
s'alaschoit	cessoit (G1)	1
icel	cest (G1)	1
ceste chose	cest miracle (G1)	1
c'est	ceste (G1)	1
oiseaus	ceuls (G1)	1
chanter	chantans (G1)	1
conmencier a	chanter ne (G1)	1
chamel	cheval (G1)	1
clers	chevaliers (G1)	1
chevauchierent un jor par la cité	chevauchoient par la cité un jour (G1)	1
seint	chier (G1)	1
il	ci (G1)	1
li seinz hom	cil (G1)	1
le conmant	conmandement (G1)	1
de par nostre Signor fet le conmandement	conmandé de par nostre Seigneur (G1)	1
en coi	conme (G1)	1
ne ne sevent noient	conme cil qui rien ne savoient (G1)	1
de boivre aprés lui com li prestres	conme li prestres estoit d'aprés lui boivre (G1)	1
recomencierent	conmencierent (G1)	1
ploroient	conmencierent a plorer (G1)	1
convertirent pres qe tuit	conmencierent pres que tuit a convertir (G1)	1
covoita molt	conmença (G1)	1
conmença	conmença a debrisier (G1)	1
l'avoit acuellie	conmença en tel maniere (G1)	1
recomençoit	conmençoit (G1)	1
reconta	conta (G1)	2
conta	conta le miracle (G1)	1
raconterai	conterai (G1)	1
encontre	contre (G1)	6
terre	contree (G1)	1
dite	conté (G1)	1
conté	conté et dit (G1)	1
corçoit	correceroit (G1)	1
tresor	cors (G1)	1
creance	creance qu'il avoient (G1)	1
creoient	creoient mie tuit (G1)	1
crioit	crioit durement (G1)	1
croiz	crois qui en celi estoit (G1)	1
cruel	crueuse (G1)	1
a	d' (G1)	1
a aler	d'aler (G1)	1
de diversitez	d'aversitez (G1)	1
richesces et avoirs	d'avoir et (G1)	1
de sa ceaille	d'els fors de sa cealle (C3 G1)	1
de la	d'ilec (G1)	1
departiz	d'ilec partiz (G1)	1
seur costé	d'un costé sur l'autre (G1)	1
ou li jovenceaus	d'un jouvencel ou il (G1)	1
pucele	damoiseles (G1)	1
del	de (G1)	12
Venus	de Veneris (G1)	1
qi	de cels qi (G1)	1
des	de ces (G1)	1
molt dolereusement	de doulereuse paine (G1)	1
molt blanche	de grant blanchor (G1)	1
granz et pesanz	de grant pesantor (G1)	1
envers nostre Seignor de haute merite	de haute merite envers nostre seignor (G1)	1
acompliz de grantde grant de grant richesce	de haute seignorie et riches (G1)	1
del chaïement	de la chaleur qu'il avoit (G1)	1
de foi et de religion	de la foi et de la relegion (G1)	1
del signe  de la	de la sainte (G1)	1
nostre	de nostre (G1)	1
nostre Signor	de nostre Seigneur (G1)	3
d'Antecrist	de nostre Seignor (G1)	2
palezins avoit	de palazine estoit (G1)	1
par	de par (C2 G1)	1
d'oster	de porter et d'oster (G1)	1
dont	de qui (G1)	1
noient	de rien (G1)	1
a ses euz	de sa veüe (G1)	1
seint Pierre de Coloigne	de saint Pere a Coloigne (G1)	1
et mondee de	de son cors (G1)	1
enemis	deables (G1)	2
combrisiez	debrisiez (G1)	1
en	dedens (G1)	1
faillir	deffaillir (C2 G1)	1
lessa quanq'il avoit	deguerpi toutes ses choses terrienes (G1)	1
defors	dehors (G1)	2
de lor	del (G1)	1
la dedenz seoient	delaienz (G1)	1
manderent	demanderent (C2 C3 G1)	1
pucele	demoisele (C2 G1)	1
a esté	demora (G1)	1
l'amour de	demorer avec (G1)	1
mostroit	demostroit (C2 C3 G1)	1
de l'eveschié	des eveschés (G1)	1
de .ii. liues	des liex (G1)	1
deci	des ore (G1)	1
freres	desciples (G1)	1
desirres	desirres molt (G1)	1
vousist	desirroit (G1)	1
liu trestorné	destour lieu (G1)	1
forsenerie	desverie (G1)	1
ravaler	devaler (G1)	1
en	devant (G1)	3
mostrer devant lui	devant lui demener (G1)	1
vers	devers (G1)	1
totes genz doivent	devoient bien toutes genz (G1)	1
deïst	deïst croire (G1)	1
lire	dire (G1)	1
parla	dist (G1)	2
conmanda et dist	dist et reconta (G1)	1
firent	distrent (G1)	1
einsi parlé	dit ceste chose et recontee (G1)	1
desertes	diverses (C2 G1)	1
pueent	doivent (G1)	1
malades	dolent (G1)	1
de paine et de doleur	doleur et paine (G1)	1
sols	dons (G1)	1
q'	dont (G1)	2
dont ci comence la vie	dont je vous dirai la vie (G1)	1
qi estoit clos et serrez	dont li huis estoit serrez (G1)	1
donroit	dounoit (G1)	1
doutance	doute (G1)	2
de son	du (G1)	2
de l'enemi	du deable (G1)	1
de l'evesqe qi Perpetuus avoit non	du saint archevesque qui propetuus estoit apelez (G1)	1
procheine del temple	du temple molt prochaine (G1)	1
pleinement	du tout (G1)	1
tresq'	dusques (G1)	1
tresq'a ce jor	dusques a cel jour (G1)	1
tresq'a tierz jor	dusques a tiers jour (G1)	1
ja (#C3)	ije (C1 C2 G1)	1
ensamble o les angeles	em paradis avec les autres angeles (G1)	1
dedenz	en (G1)	9
en	en a on (G1)	1
el	en ce (G1)	1
muer ne trestorner en nule maniere. ne en nule forme	en cele maniere transfigurer ne muer (G1)	1
Einsi	en cele nuit (G1)	1
chaçassent	en chassassent (G1)	1
creanz	en creance (G1)	1
furent	en furent (C2 C3 G1)	1
de la contree de Pannone	en la citeé de Pannonie (G1)	1
el chief	en la teste (G1)	1
en	en mi sa voie en (G1)	1
s'en son lit non: sor	en nul lieu fors seulement a (G1)	1
grant dotancedote	en paour et en doutance (G1)	1
en sa pensee	en pensé (G1)	1
el plus seür	en pluseurs (G1)	1
tant	en tant (G1)	1
pres de morir en tel maniere	en tel maniere atornez (G1)	1
el	en un (G1)	1
chaça	enchassa (G1)	1
a	encontre (G1)	2
par lui pardon et misericorde	encore merci et par sa misericorde (G1)	1
dementieres	endementieres (G1)	1
dementieres	endementres (G1)	2
dejoste soi	enpres lui (G1)	1
aussi	ensement (G1)	1
escoutés dont	entendez et escoutez (G1)	1
ooient soventes foiz	entendoient pluseurs fiees (G1)	1
n'entendoit	entendoit (G1)	1
torner	entendre (G1)	1
diligense	entente (G1)	1
ot le colp entesé	entesoit le cop (G1)	1
environ	entor (G1)	1
environ	entour (G1)	3
qe	entr'eus de ce qu'il (G1)	1
te delessoies de	entrelessoient (G1)	1
contre	envers (G1)	4
envers	envers par (G1)	1
entour	environ (G1)	1
estoient	erent (G1)	1
errant	errament (C2 G1)	1
creance	errance (G1)	1
l'en l'escriture	es escriture (G1)	1
eslevez	esleeciez (G1)	1
eslevez	esleuz (C2 C3 G1)	1
removoir le	esmouvoir (G1)	1
remuer le	esmouvoir plus haut (G1)	1
desnuer	esnuer (G1)	1
gardoient	esperoient (G1)	1
metre en poor et 	espoenter et metre (G1)	1
ressaierent	essaierent (G1)	1
ait ele	est (G1)	3
erent	estoient (G1)	5
erent	estoient avec lui (G1)	1
estoit venuz li proioit	estoient venu li prioient (G1)	1
ert	estoit (G1)	14
avoit non	estoit apelez (G1)	4
avoit non	estoit apelez en la cité (G1)	1
avoit non	estoit apelez par non (G1)	1
maumise ert	estoit malade (G1)	1
venuz ert	estoit venuz (G1)	1
nestre	estre (G1)	1
car	et (G1)	14
a	et a (G1)	1
molt sovent meint  bel miracle	et a fait maintes beles miracles (G1)	1
a demener	et amena (G1)	1
avoient	et avoient (G1)	1
de la	et d'autre part (G1)	1
et de quel creance.	et de quel contree et de quel creance (G1)	1
qui leur disoient (#C2)	et disoient (G1)	1
dist	et dist (G1)	1
si	et dont (G1)	1
en	et en (G1)	1
il ne por qant	et ensivoit (G1)	1
escuz	et escuz (G1)	1
fist	et fist (G1)	1
ne ne presçoie	et guerpissoie aprés (G1)	1
q'il	et le (G1)	1
lendemein: et si	et lendemain (G1)	1
par	et par (G1)	2
pres que tote et 	et pres que tout (G1)	1
de s'enfermeté et curee	et sanee de s'enfermeté (G1)	1
car il	et si (G1)	1
si le blasmoit par mout laides paroles	et si l'en blasmoit molt (G1)	1
si debrisa et destruist	et si le trebuscha (G1)	1
si s'en vindrent tout aval	et si se mistrent contreval (G1)	1
tant	et tant (G1)	1
tant qe	et tant que (G1)	1
Ensement	et toutevoies (G1)	1
ceus	euls (G1)	1
espace	eure (G1)	1
hom	evesques (G1)	1
creüssent	eüssent fiance (G1)	1
disoit	faisoit (G1)	1
fetes lor maisonceles	fait leur habitacle (G1)	1
sera	fera (G1)	1
greveroient	feroient elles nule grevance (G1)	1
feste	feste anuel (G1)	1
deu	feu (G1)	1
defina	fina (G1)	1
fu	fist (G1)	1
loy	foi (G1)	1
confondus	fonduz (G1)	1
fuie	force (G1)	1
formes	forme (G1)	1
qi en lui estoit	fors (G1)	1
qe	fors que (G1)	2
fil	frere (G1)	1
ert	fu (G1)	1
fu	fu il (G1)	1
vint	fu une nuiz (G1)	1
fumiere	fumee (G1)	1
furent	furent hors (G1)	1
venist	fust (G1)	2
avoir lui meïsmes garanti	garantir lui meïsmes (G1)	1
guetoit	gardoit (G1)	1
se pleinstrent et gemirent	gemirent et plainstrent (G1)	1
pluiseurs	genz (G1)	1
rien	goute (G1)	1
doit governer	gouverne (G1)	1
jemissoient	gramentoient (G1)	1
lonc	grant (G1)	4
torbe	grant assemblee des gens (G1)	1
grant joie et de grant esleecement	grant lieece et de grant joie (G1)	1
cremeur	grant paour (G1)	1
longuement	grant piece (G1)	2
grant piece le tens	grant piece devant (G1)	1
bien	granz (G1)	2
a plein: et la chaleur		
                desmesuree	granz a plain et la chaleur granz et desmesuree (G1)	1
deguerpir	guerpir (C2 G1)	1
sanz poor	hardiement (G1)	1
heitiement	hastivement (G1)	1
leva	haucha (G1)	1
grant	haute (G1)	1
vertu	haute vertu (G1)	1
orissons	heures (G1)	1
signorie et reverence	honneur et seignorie (G1)	1
fors	hors (G1)	2
de	hors de (G1)	1
desjoins del jou	hors de son jou issu et desliez (G1)	1
hastivement	hui le saint home sanz demorance (G1)	1
oï	i ot (G1)	1
celui	icelui (G1)	1
estoit	iert (G1)	4
i	il (G1)	11
une si grant torbe de deables vint	il oïrent une grant torbe de deables venant aprés (G1)	1
tant li feïst	il tantost si fist (G1)	1
il	ilec (G1)	4
ancien	iluec (G1)	2
qi la destreignoit	issue et chacie (G1)	1
mie	ja (G1)	2
reconois	je connois (G1)	1
je sui Crist	je suis Jhesu Crist (G1)	1
gloire	joie (G1)	1
gloire ou nos tuit puissonspuissions tuit parvenir	joie sanz fin (G1)	1
juignet	juing (G1)	1
a terre	jus a terre (G1)	1
tresc'a	jusque (G1)	1
tresq	jusques (G1)	2
tresq'a hui cest jor enluminee		
                et florie	jusques a l'eure Dieu enluminee et florie (G1)	1
tresq'a la matinee	jusques a la matinee (G1)	1
tresq'a la nuit	jusques a la nuit (G1)	1
tresq'a hui cest jor	jusques a ores (G1)	1
tresq'au	jusques au (G1)	2
tresq'au tierz jor	jusques au tiers (G1)	1
cele fole 	l' (G1)	2
Maxime l'empereor	l'empereor (G1)	1
li hom purgier	l'on espurgier (G1)	1
li un et li autre	l'une partie et l'autre (G1)	1
l'une	la (G1)	6
l'assemblee	la communité (G1)	1
restreindre la chariole, ce est la coroie dont li		
                jous estoit liés as cornes	la corne destraindre dont il estoit desliez as cornes (G1)	1
sa fille	la damoisele (G1)	1
cele malvese	la fausse (G1)	1
la ceaille	la maison (G1)	1
l'eure de mienuit vint	la nuit fu venue (G1)	1
et la	la ou (G1)	8
aussint com	la ou il estoient (G1)	1
qui la	la qui (G1)	1
seinte loy	la sainte foi (G1)	1
il l'eveschié	la seignorie en habit de moine (G1)	1
soloient	la souloient (G1)	1
ses granz vertuz	la vertu nostre Seigneur (G1)	1
lez et hisdeus et cruel	laide et noire et crueuse (G1)	1
vileinement	laidement (G1)	1
la dedenz	laiens (G1)	1
la dedenz	laienz et toutes heures (G1)	1
lever	laver (G1)	1
la	le (C2 C3 G1)	5
bailla la coupe	le bailla (G1)	1
baillast	le baillast (G1)	1
l'embatroit	le batroit (G1)	1
la besoigne	le besoing (G1)	1
les  trespassanz	le chemin (G1)	1
le conmencierent a escharnir	le conmencierent a gaber (G1)	1
devez bien croire	le devez croire (G1)	1
devoit	le devoit mie (G1)	1
lessier a mengier en	le estrangier de (G1)	1
l'en detint et retraist	le fist atargier (G1)	1
la glorieuse vie qi toz tens duerra: ne ja ne prendra fin	le glorieus siege des sainz ciels (G1)	1
la feste del jor	le jour de la feste (G1)	1
la vesteüre	le mantel (G1)	1
le pueple	le monde (G1)	1
la poitrine	le piz (G1)	1
le roiaume	le regne (G1)	1
seinz Martins	le saint hom saint Martin (G1)	1
le serjant	le sergent au consse (G1)	1
signum crucis	le signe de la croiz (G1)	1
et qi tout ce vit le nos raconte	le tesmoigne et reconte (G1)	1
l'entraioient	le traioient en tel maniere (G1)	1
l'arcevesqié	le veschié (G1)	1
proprement le vit	le vit premierement (G1)	1
en l'eglisse	leanz (G1)	1
ses	les (G1)	3
lumieres	les lumieres (G1)	1
ses oevres	les oeuvres saint Martin (G1)	1
cez choses qi sont petites	les petites choses en pes (G1)	1
hauz cuens	les plusors (G1)	1
les covroient de blans dras, si les		
                comportoient	les portoient et si les couvroient de blanz dras (G1)	1
deguerpisse	lesse (G1)	1
li	leur (G1)	2
conmanda	leur conmanda (G1)	1
si parla et lor dist	leur dist tiex paroles (G1)	1
lor cuers et lor ententes	leur ententes et leur cuers (G1)	1
faisoit	leur fesoit (G1)	1
lor guerissons	leur garisons et leur regnes (G1)	1
son propre patron	leur propre patremoine (G1)	1
releverent de terre	leverent (G1)	1
lor	li (G1)	7
i ala por lui amener	li amena tantost (G1)	1
et si erent	li ancien estoient (G1)	1
li beneoiz chevaliers seinz Martins	li beneoiz le tres saint chevalier Martin (G1)	1
voloit li bons archevesqes	li bons evesques vouloit (G1)	1
comandast	li conmandast (G1)	1
lor demoustrast	li demoustrassent (G1)	1
disoit erent males	li disoit estoient mauvaises (G1)	1
dist	li dist (G1)	2
respondi seinz Martins. et si dist	li dist saint Martin (G1)	1
l'avoit grevé	li estoit agregiee (G1)	1
ou	li liex ou (G1)	1
s'en departirent li oisel	li oisel s'en partirent (G1)	1
recoumença	li reconmença (G1)	1
respondi	li respondi (G1)	1
d'un	li saint (G1)	1
seinz Martins	li saint hom (G1)	3
a evesqe en la cité de Tors li seinz hom	li sainz hom ordenez a evesque (G1)	1
li hom	li seinz hom (C3 G1)	1
se movoient	li trembloient (G1)	1
disoit	lisoit (G1)	1
lonc tens	longuement (G1)	1
eü mout longement	longuement eü (G1)	1
dementieres	lors (G1)	1
soi	lui (G1)	1
la mere nostre Signor Jesu Crist	ma Dame sainte Marie (G1)	1
demeinent	mainent (G1)	1
pluiseurs seintes oevres	maintes oevres saintes (G1)	1
mesoncele	maison (G1)	1
malveses	males (G1)	1
demenee	malmenee (G1)	1
guisse	maniere (G1)	1
fole	mauvaise (G1)	1
fole	mauveses (G1)	1
sera	me sera (G1)	1
meïsmes	meesmement (G1)	1
amenerent	menerent (G1)	1
ensamble o lui mengeroit	mengeroit avec lui (G1)	1
mentent	mentoient (G1)	1
esmervellier	merveillier (G1)	1
porpensoient	merveilloient (G1)	1
cez	mes (G1)	3
entremis	meslez (G1)	1
meson	mesnie (G1)	1
li seinz hom	messires saint Martin (G1)	1
pasteur	mestre (G1)	1
si entendist	meïst en l'escouter grant entente (G1)	1
son chemin	mi sa voie (G1)	1
et 	mie (G1)	1
apris n'acostumé	mie acoustumé (G1)	1
pas mout loing	mie granment (G1)	1
receü	mie receü (G1)	1
mie	mie, ce cuit (G1)	1
meins estre	mielz (G1)	1
remise	mis (G1)	1
granz torbes	molt (G1)	2
por ce	molt de ce (G1)	1
Li empereres si fu molt liez	molt fu liez li emperieres de grant maniere (G1)	1
granz a desmesure	molt grant et demesuree (G1)	1
en tel point	molt por lui einssi a malaise (G1)	1
environ li mout dolent	molt pour lui dolent (G1)	1
povre  home nuz	molt povre nu (G1)	1
siecle	monde (G1)	1
del cors	monseigneur (G1)	1
seint Martin	monseigneur saint Martin (G1)	1
oevres	mors (G1)	1
n'avoit se pou non devantde tens sans vie	mort un poi devant (G1)	1
tres cruieus	mortiex (G1)	1
demostrast	moustrast (G1)	1
demostré	moustré (G1)	1
n'orent poor de princes	n'avoient nule paour d'espees (G1)	1
n'en avoit ne poor	n'avoit du deable paour (G1)	1
novelement	n'avoit encor se petit non (G1)	1
ne l'en avoit fait premierspremiers fet conmandement ou signe	n'en donnoit congié, si cuida ?? li saint hom li feïst	
                signe (G1)	1	
entendoit	n'entendoit (C3 G1)	1
noient. ne sont	n'estoient (G1)	1
encor n'estoient mie bien affermez en la		
                seinte creance	n'estoient mie encore en ferme creance ne en vraie (G1)	1
del travail sosfrir n'estoit mie		
                veincuz	n'estoit encor mie lassez de travail soffrir (G1)	1
n'avoient	n'i avoit (G1)	1
n'estoit la nus hom	n'i ot celui (G1)	1
ne	n'il (G1)	1
n'osoit	n'osoit mie (G1)	1
n'entent	n'ot eut (G1)	1
non	ne (G1)	7
et ensamble o	ne avec (G1)	1
et corone	ne coronne d'or (G1)	1
n'en cuidoit	ne cuidoit mie (G1)	1
non mie grantlonc terme trespassé	ne demora mie (G1)	1
ne	ne il (G1)	1
del empire	ne l'empire (G1)	1
nes osa	ne l'osa (G1)	1
ne	ne n' (G1)	1
et de nule rien n'ert sostenue	ne n'estoit de nule chose soustenue (G1)	1
n'i	ne n'i (G1)	1
Ne	ne ne (G1)	2
car il ne cessoit	ne ne finoit (G1)	1
ne pot onques estre menez a ce	ne ne volt onques a ce estre menez (G1)	1
qe son mantel	ne nule autre creature que son mantel (G1)	1
ne misericorde	ne nule misericorde (G1)	1
n'i porroit durer	ne pooit durer en nule maniere (G1)	1
pluiseurs	ne sai qans (G1)	1
n'en pueent estre	ne seront ja (G1)	1
je ne vous sai dire	ne vos sai a dire (G1)	1
nonpor qant	nequedent (G1)	2
n'ot	non (G1)	2
et nient	non mie (G1)	1
nonsachanz	nonchalanz (G1)	1
de Deu	nostre Seigneur (G1)	1
Dex	nostre Sire (G1)	1
les	noz (G1)	1
fait au povre home nul bien	nul bien fait au povre home (G1)	1
rieng	nule chose (G1)	1
chose nule	nule creature (G1)	1
nul	nus (G1)	2
tuit cil qui  a lui venoient i recevoient		
                santé	nus malades ne venoit a lui qui molt tost n'eüst santé receüe (G1)	1
nus	nus moines (G1)	1
eü ne doleur ne bleceüre	onques eu nule bleceüre (G1)	1
onques	onques si tost (G1)	1
ensivoient	ont (G1)	1
rot	ot (C2 C3 G1)	1
encovença	ot en couvent (G1)	1
Si	ou (G1)	1
ices choses oï	oï ces choses (G1)	1
vos veoir	oïr (G1)	2
la pes entre	pais en (G1)	1
feire la pes	pais faire (G1)	1
et 	par (G1)	3
par ce il	par ce qu'il (C2 C3 G1)	1
del cors de celui par derriers	par desriere de celui (G1)	1
envers nostre Signor par la doctrine del		
                seint home	par la volenté de nostre seigneur et par la doctrine du saint	
                home (G1)	1	
a pluisors croire par lor folies	par leur folies les pluseurs croire en lui (G1)	1
mie avoir pardon	pardon avoir (G1)	1
parmenable	pardurable (G1)	1
fin	parfin (C2 C3 G1)	1
par mi	parmi le milieu (G1)	1
departi	parti (G1)	2
parz	parties (G1)	1
trestorner ne partir	partir ne destorner en nule maniere (G1)	1
mie	pas (G1)	2
mie volentiers deguerpir	pas deservir (G1)	1
il ne le veoient mie	pas ne le veoient (G1)	1
trespassa	passa (G1)	1
se mut: ne pas avant ne		
                pas arriere	passa avant ne arriere (G1)	1
trespercerai. et trespasserai	passerai et trespercerai (G1)	1
trespassé	passé (C2 C3 G1)	2
pensoient	penserent (G1)	1
pooit	peüst (G1)	1
seüst fere	peüst fere (G1)	1
tout ardant	plain de grant ardure (G1)	1
tout plenierement	plainement (G1)	1
pleur	plains (G1)	1
pueples	plainz (G1)	1
la pleniere bataille	pleniere bataille (G1)	1
pleinement	plenierement (G1)	1
loist	plest (G1)	1
autre oevre	plus (G1)	2
plus cler qe nule clarté ne qe nule lumiere	plus que nule autre clarté de nule lumiere (G1)	1
li auqant	pluseurs (G1)	2
evesqes	pluseurs evesques (G1)	1
meintes	plusieurs (G1)	1
poissance	poesté (G1)	1
poez veoir	poez (G1)	2
q'il peüssent	por (G1)	2
pooit	pot (G1)	2
de	pour (G1)	6
tantost	pour ce (G1)	2
por ce	pour ce qu'il vouloit (G1)	1
Et por ce	pour ce que (G1)	1
tuer le seint home	pour lui ferir (G1)	1
q'a pou	pour poi (G1)	1
coment	pour quel maniere (G1)	1
povre	povre home (G1)	1
visiter	preechier (G1)	1
prestres	prelas (G1)	1
poindera	prendra (G1)	1
ja estoit pres qe morte	pres estoit de morte (G1)	1
seinz hom	preudom (G1)	2
premiers	primes (G1)	1
esprist el fuerre	prist en l'estrain (G1)	1
proisme	prochain ami (G1)	1
hastivement	prochainement (G1)	1
feïssent lor orissons a	proiassent (G1)	1
parole	proiere (G1)	1
dit	promis (G1)	1
si	puis (G1)	5
puis	puis cele heure (G1)	1
toz tens aprés	puis touz tanz (G1)	1
com	qant (G1)	1
ou	qe (G1)	1
qant	qu' (G1)	1
cil qi	qu'il (G1)	9
qe se ce fust	qu'il feïst (G1)	1
contreval	qu'il fist contreval (G1)	1
qe meintenant manda il	qu'il manda (G1)	1
le porsivoient	qu'il moustroit et enseignoit (G1)	1
qe nul bien ne li firent	qu'il n'i ot nul qui bien li feïst (G1)	1
qi en la croiz li furent fetes	qu'il ot en la croiz (G1)	1
et il fu repairiez	qu'il retorna arriere a sa ciaulle (G1)	1
une partie d'els aler encontre	qu'une des parties d'els alast encontre (G1)	1
com	quant (G1)	4
par ce qu'il a eus les		
                atouçoient	quant il en estoient atouchié (G1)	1
c'onqes	que (G1)	11
qi	que elle (G1)	1
c'on	que l'en (G1)	1
un pou de vil fuerre desoz lui metre	que l'en li meïst un poi d'estrain souz lui (G1)	1
qui c'onqes	que qui onques (G1)	1
qi a sa feme iert prise	que sa fame avoit prise (G1)	1
q'il	qui (G1)	7
se descordoient	qui ainssi les desheritoient (G1)	1
q' il avoit	qui avoit (G1)	1
et les seintes reliqes et les croiz		
                  et .vii. cierges i furent aportez tos ardanz	qui avoit aportees les croiz et les saintes reliques et .vii. cierges ardans (G1)	1
qe bien peüssent avoir fait	qui bien le poïssent faire (G1)	1
c'on en lui veoit	qui en lui estoit (G1)	1
meïst sa mein qi dervez estoit	qui estoit desvez meïst sa main (G1)	1
q'il les enmeine	qui les enmeine (C3 G1)	1
li	qui li (G1)	1
des plus  hardiz	qui plus estoit hardiz (G1)	1
cuida	quida et crut (G1)	1
quel chose	quoi (G1)	1
verais messages	uvrais messages ou non (G1)	1
regardast et coneüst	reconneüst et regardast (G1)	1
contant	recontant (G1)	1
s'en courut	recouroit (G1)	1
covert	recouvert (G1)	1
douta	redouta (G1)	1
esgarderent	regarderent (G1)	1
regarderent	regarderent tuit (G1)	1
esgardoient	regardoit (G1)	1
dist	regehis (G1)	1
lever le	relever (G1)	1
movoir	remouvoir (G1)	2
murent	remuerent (G1)	1
dist	respondi (G1)	1
repaira	retorna (G1)	2
repairast	retornast (G1)	2
repaireroit	retorneroit (G1)	1
vestuz	revestuz (G1)	1
visitast	revisitast (G1)	1
viel	riche (G1)	1
nule chose	rien (G1)	1
roses	rousee (G1)	1
se pooit envers lui covrir por pooir qu'il eüst	s'an pooit couvrir en nule guise (G1)	1
s'asistrent	s'asentirent (G1)	1
venoient	s'assembloient (G1)	1
se tornerent	s'atornerent (G1)	1
si	s'en (G1)	1
se torna de la ou il estoit. et entra en un serjant de la meson	s'en ala et encontra un sergent de la maison, si li entra el cors (G1)	1
aloient ensamble dejoste un flun	s'en aloient en tel maniere ensemble saint Martin (G1)	1
erent en abstinence	s'en atenoient (G1)	1
se movoit il mie dedenz son cuer ne ne trestornoit	s'en esmaioit de rien en son cuer (G1)	1
repeirierent en lor contrees	s'en repairierent a leur contrees (G1)	1
ira plus aparelliement la voie qu'il doit		
                  aler a nostre Seignor	s'en vait la voie qu'il doit plus prestement a nostre Seigneur	
                  aler (G1)	1	
se mellast	s'entremeïst (G1)	1
venoient	s'esjoïssoient (G1)	1
l'espee	s'espee (G1)	1
si estoit	s'estoit (C2 C3 G1)	1
toz esmariz	s'il fust touz esfreez (G1)	1
s'enfermetez ne le destreignoit	s'il n'avoit enfermeté (G1)	1
la	sa (G1)	1
la celle au seint home	sa ciaulle (G1)	1
cele	sa fille (G1)	1
ce q'il morust	sa mort (G1)	1
ele	sa vesteüre (G1)	2
li seinz hom	saint Martin (G1)	1
se mist seinz Martins a la voie	saint Martin ala sa voie (G1)	1
fet seinz Martins	saint Martin faite (G1)	1
vint seinz Martins	saint Martin s'en vint (G1)	1
seinz	saint home (G1)	1
vraie	sainte (G1)	1
croiz	sainte vraie croiz (G1)	1
lava	sana (G1)	1
mondez	sanez (G1)	1
sanz mal avoir. et sanz grevance	sanz avoir paine ne mal (G1)	1
poés vos 	sanz faille poez (G1)	1
seürement	sanz nule doute (G1)	1
garantie	sauvee (G1)	1
esgarder	savoir (G1)	1
s'en	se (G1)	3
fu reporpensés	se fu porpenssez (G1)	1
s'en esmerveillierent	se merveillierent (G1)	1
se tresmuoit il et aparoit	se metoit il et s'aparoit (G1)	1
par dolereus martyre muert et perist en langor	se muert par dolereuse maniere de maladie (G1)	1
porpensa	se porpenssa (G1)	1
se vozse vos se vos sa vie volez oïr	se sa vie voulez paroïr (G1)	1
sorent	se sorent (C2 C3 G1)	1
conqerre	secorre aquerre et avoir (G1)	1
serjant	seigneur (G1)	1
resembloit	sembloit (G1)	1
ensivir	servir (G1)	1
souz et 	ses (G1)	2
les pluisors de ses freres	ses freres les pluseurs (G1)	1
ne n'avoit autres coutes	seur ce avoit acoustumé a gesir (G1)	1
venir sor eus	seur euls venir (G1)	1
trestoz	si (G1)	7
si c'on	si conme on (G1)	1
deciple	si desciple (G1)	1
desfez	si desfait (G1)	1
dist	si dist (C2 G1)	1
q'a poi	si durement que pres s'en ala (G1)	1
si ert il si douz et si pius	si estoit dolz et debonaires (G1)	1
tant pesoit	si estoit pesanz (G1)	1
et se	si le (G1)	1
mes il abandona	si li tendi (G1)	1
manda	si manda (G1)	1
s'avoients'avoier : se diriger		
                vers par autel maniere	si metent molt de legier (G1)	1
ne s'i seüst atapir	si ne seüst mucier (G1)	1
tieus poissance	si puissanz (G1)	1
et seisi parmi les braz, si	si qu'il (G1)	1
la flambe ne li feus	si que la chalor et la flambe (G1)	1
s'aparut	si s'apparut (G1)	1
se	si se (G1)	1
et si devoit l'en asoudre	si se devoit on avouer (G1)	1
il vit plunjons	si veoit pluions en un flun (G1)	1
j'ai ja fait le service trestot	sien ai tout fait le service (G1)	1
afaires	signes (G1)	1
foie	soe (G1)	1
poil	soie (C2 G1)	1
cenaill (#C2 #C3)	solier (G1)	1
le	son (G1)	3
un de ses iols	son oeil (G1)	1
sosfrir l'arbre a abatre	souffrir a depecier l'arbre ne a abatre (G1)	1
sosfroient	souffrirent (G1)	1
lessast	souffrist (G1)	1
soventes foiz joïes	souvent veües (G1)	1
secce	suite (G1)	1
ma	ta (G1)	1
estoient	tant estoient (G1)	1
de Tors tant seulement	tant seulement de la (G1)	1
fors tant seulement	tant seulement que (G1)	2
tost	tantost (G1)	2
le tens	tantost le tans (G1)	1
gardee	tenue (G1)	1
contree	terre (G1)	1
tele oevre	tiex (G1)	2
repairierent	tornerent (G1)	1
mis et assis en son lieu	tornez et conreez (G1)	1
mout s'en esmervellierent, si	tout droitement (G1)	1
environ	tout entour (G1)	1
tote sa voie	tout son chemin (G1)	1
ceste	toute (G1)	1
tant conme la nuit dura tresc'a		
                la jornee	toute nuit dusques a la journee (G1)	1
tieus	toutes ces (G1)	1
cez	toutes les (G1)	1
ne qe dent	toutes voies (G1)	2
trestoz	touz (G1)	4
issir toz cels qi en l'ostel estoient hors	touz cels issir hors qui laiens estoient (G1)	1
toz tens	touz jourz (G1)	1
retrest	traist (G1)	1
pener ne traveillier	travaillier ne esforcier (G1)	1
revellierent  il	travaillierent (G1)	1
acraventa	trebuscha (G1)	1
vendra trebuchant	trebuschera par grant ravine (G1)	1
escroller	trembler (G1)	1
tresc'a	tres aprés (G1)	1
trespassement	trespasse (G1)	1
le trespasserent	trespasserent le povre (G1)	1
issuz	trespassé (G1)	1
toz	trestoz (G1)	1
dolenz	triste (G1)	1
un pou	trop poi (G1)	1
li pasteur n'i sera mie	tu n'i seras mie (G1)	1
trestuit	tuit (G1)	5
cil	tuit cil (G1)	3
qi les	tuit cil qui leur pechiez (G1)	1
li	tuit li (G1)	1
li clergiés qi la estoient assemblez	tuit li autre clergié (G1)	1
le	un (G1)	2
une tombe d'un home qi iluec estoit enfouiz	un cors enfoui en une tombe (G1)	1
por lui ferir d'un coutre		
                et ocirre	un coutel en sa main pour lui ferir et occire (G1)	1
pou	un poi (G1)	1
oï et entendu un pou ceste chose	un poi entendu ces choses (G1)	1
celui qi de vin i gostast onqes	un qui beüst de vin (G1)	1
nul	un seul (C2 G1)	1
en un secré leu	un siege en un des liex (G1)	1
la	une (G1)	1
l'antevene	une anthiene (G1)	1
une seule haire	une haire tant seulement (G1)	1
un leu	une voie (G1)	1
meüssent	venissent (G1)	1
a la cité venist	venist avec lui jusques a la cité (G1)	1
par devers	vers (G1)	1
cote	vesteüre (G1)	1
revestoit	vestoit (G1)	1
meïsmes ai veües	veul (G1)	2
avons en nostre tens veü	veïsmes en noz tans (G1)	1
vivre	vif (G1)	1
citez	viles (G1)	1
parvindrent	vindrent (G1)	2
se trestretrest li seinz hom	vint (G1)	2
i acorut	vint et acorut (G1)	1
vindrent mout de vileinz	vint une grant torbe de vilains (G1)	1
de ceste vie	vit (G1)	1
fu en vie	vivoit (G1)	1
lumiere	voie (G1)	1
les povres et  les chetis	volentiers as povres et as mendis (G1)	1
voellance	volenté (G1)	1
volenté	volenté de (G1)	1
voloit	voloit on (G1)	1
requerons nos et volons avoir	volons nous avoir (G1)	1
voloit	volt onques (G1)	1
voloit	volt rien (G1)	1
voudroit	voudra (G1)	1
vout	vouloit (G1)	1
mes	voz (G1)	1
orissons	vraie creance (G1)	1
estoient venuz et assamblez	y estoient assemblé (G1)	1
