Graphie du mot Dieu $9

lemme : dieu	Nombres d'occurrences : 195
dé	1	POS=NOMpro|NOMB.=s|GENRE=m|CAS=r	1	
deus	1	POS=OUT|NOMB.=s|GENRE=m|CAS=n	1	
diu	2	POS=NOMcom|NOMB.=s|GENRE=m|CAS=r	1	POS=NOMpro|NOMB.=s|GENRE=m|CAS=r	1	
dex	79	POS=NOMpro|NOMB.=s|GENRE=m|CAS=n	59	POS=NOMcom|NOMB.=p|GENRE=m|CAS=r	6	POS=NOMcom|NOMB.=s|GENRE=m|CAS=n	14	
deu	112	POS=NOMpro|NOMB.=s|GENRE=m|CAS=r	88	POS=NOMcom|NOMB.=s|GENRE=m|CAS=n	2	POS=NOMcom|NOMB.=p|GENRE=f|CAS=r	1	POS=NOMcom|NOMB.=s|GENRE=m|CAS=r	18	POS=NOMcom|NOMB.=p|GENRE=m|CAS=r	1	POS=NOMpro|NOMB.=s|GENRE=m|CAS=n	1	POS=NOMcom|NOMB.=p|GENRE=m|CAS=n	1	

Graphie du mot lieu $25

lemme : lieu	Nombres d'occurrences : 142
lieus	1	POS=NOMcom|NOMB.=p|GENRE=m|CAS=r	1	
lieu	3	POS=NOMcom|NOMB.=s|GENRE=m|CAS=r	2	POS=NOMcom|NOMB.=s|GENRE=m|CAS=r|DEGRE=p	1	
lius	4	POS=NOMcom|NOMB.=s|GENRE=m|CAS=n	1	POS=NOMcom|NOMB.=p|GENRE=m|CAS=r	3	
liu	13	POS=NOMcom|NOMB.=s|GENRE=m|CAS=r	13	
leus	26	POS=NOMcom|NOMB.=p|GENRE=m|CAS=r	17	POS=NOMcom|NOMB.=s|GENRE=m|CAS=n	9	
leu	95	POS=NOMcom|NOMB.=s|GENRE=m|CAS=r	95	

 Réduction de e ouvert libre en i ou en e §10

Mot	Nombres d'occurrences total	Nombre d'occurrences
Lemme : maximien	5	1
maxime	1	POS=NOMpro|NOMB.=s|GENRE=m|CAS=n	1	
maximiens	4	POS=NOMpro|NOMB.=s|GENRE=m|CAS=n	4	
Lemme : antiene	2	1
antevene	1	POS=NOMcom|NOMB.=s|GENRE=f|CAS=r	1	
antiene	1	POS=NOMcom|NOMB.=s|GENRE=f|CAS=r	1	
Lemme : grief	15	1
griés	1	POS=ADJqua|NOMB.=p|GENRE=f|CAS=r|DEGRE=p	1	
gries	1	POS=ADJqua|NOMB.=p|GENRE=f|CAS=n|DEGRE=p	1	
griez	5	POS=ADJqua|NOMB.=p|GENRE=m|CAS=r|DEGRE=p	1	POS=ADJqua|NOMB.=p|GENRE=f|CAS=r|DEGRE=p	1	POS=ADJqua|NOMB.=s|GENRE=m|CAS=n|DEGRE=s	1	POS=ADJqua|NOMB.=s|GENRE=f|CAS=n|DEGRE=p	1	POS=ADJqua|NOMB.=p|GENRE=f|CAS=r|DEGRE=s	1	
grief	8	POS=ADJqua|NOMB.=s|GENRE=f|CAS=r|DEGRE=p	3	POS=ADJqua|NOMB.=s|GENRE=m|CAS=r|DEGRE=p	1	POS=ADJqua|NOMB.=s|GENRE=f|CAS=n|DEGRE=s	2	POS=ADJqua|NOMB.=s|GENRE=f|CAS=n|DEGRE=p	2	
Lemme : agnies	1	1
agniés	1	POS=NOMpro|NOMB.=s|GENRE=f|CAS=n	1	
Lemme : nepotien	6	1
nepotianum	1	POS=NOMpro|NOMB.=s|GENRE=m|CAS=r	1	
nepotiens	5	POS=NOMpro|NOMB.=s|GENRE=m|CAS=n	5	
Lemme : entier	12	1
entiere	1	POS=ADJqua|NOMB.=s|GENRE=f|CAS=r|DEGRE=p	1	
entierz	1	POS=ADJqua|NOMB.=s|GENRE=m|CAS=r|DEGRE=p	1	
entirement	1	POS=ADVgen|DEGRE=-	1	
entiers	3	POS=ADJqua|NOMB.=s|GENRE=m|CAS=n|DEGRE=p	3	
entierement	3	POS=ADVgen|DEGRE=-	2	POS=ADVgen|DEGRE=c	1	
entier	3	POS=ADJqua|NOMB.=s|GENRE=m|CAS=r|DEGRE=p	3	
Lemme : raplegier	1	1
raplegement	1	POS=NOMcom|NOMB.=s|GENRE=m|CAS=r	1	
Lemme : matiere	2	2
matere	2	POS=NOMcom|NOMB.=s|GENRE=f|CAS=n	1	POS=NOMcom|NOMB.=s|GENRE=f|CAS=r	1	
Lemme : sisiesme	4	2
sisimes	1	POS=ADJord|NOMB.=p|GENRE=f|CAS=r	1	
sisiesme	1	POS=ADJord|NOMB.=s|GENRE=m|CAS=r	1	
sissieme	1	POS=ADJord|NOMB.=s|GENRE=m|CAS=r	1	
sissime	1	POS=ADJord|NOMB.=s|GENRE=m|CAS=r	1	
Lemme : bienëuré	10	10
beneüré	1	POS=ADJqua|NOMB.=s|GENRE=m|CAS=r|DEGRE=p	1	
beneüree	1	POS=ADJqua|NOMB.=s|GENRE=f|CAS=n|DEGRE=p	1	
beneürez	2	POS=ADJqua|NOMB.=s|GENRE=m|CAS=n|DEGRE=p	2	
beneürés	2	POS=ADJqua|NOMB.=s|GENRE=m|CAS=n|DEGRE=p	2	
beneüreus	4	POS=ADJqua|NOMB.=p|GENRE=m|CAS=n|DEGRE=p	1	POS=ADJqua|NOMB.=s|GENRE=m|CAS=r|DEGRE=p	1	POS=ADJqua|NOMB.=s|GENRE=m|CAS=n|DEGRE=p	2	
Lemme : ciel	57	11
ciels	1	POS=NOMcom|NOMB.=p|GENRE=m|CAS=r	1	
cius	4	POS=NOMcom|NOMB.=p|GENRE=m|CAS=r	4	
cieus	7	POS=NOMcom|NOMB.=p|GENRE=m|CAS=r	7	
ciel	45	POS=NOMcom|NOMB.=s|GENRE=m|CAS=r	45	
Lemme : pierre	36	33
﻿pere	1	POS=NOMpro|NOMB.=s|GENRE=m|CAS=r	1	
pierre	3	POS=NOMpro|NOMB.=s|GENRE=m|CAS=r	3	
peres	12	POS=NOMpro|NOMB.=s|GENRE=m|CAS=n	12	
pere	20	POS=NOMpro|NOMB.=s|GENRE=m|CAS=r	20	

Adjectif lié au fem.	NB occ. : 4

lemme : lié1	Nombres d'occurrences : 35
lie	4	POS=ADJqua|NOMB.=s|GENRE=f|CAS=n|DEGRE=p	3	POS=ADJqua|NOMB.=s|GENRE=f|CAS=n|DEGRE=c	1	

 reduction de e ouvert > ie §11

Mot	Nombres d'occurrences total	Nombre d'occurrences
Lemme : chastel	40	1
chastiel	1	POS=NOMcom|NOMB.=s|GENRE=m|CAS=r	1	
chastiaus	4	POS=NOMcom|NOMB.=s|GENRE=m|CAS=n	2	POS=NOMcom|NOMB.=p|GENRE=m|CAS=r	2	
chasteaus	5	POS=NOMcom|NOMB.=p|GENRE=m|CAS=r	4	POS=NOMcom|NOMB.=s|GENRE=m|CAS=n	1	
chastel	30	POS=NOMcom|NOMB.=s|GENRE=m|CAS=r	30	
Lemme : proprïeté	1	1
proprietet	1	POS=NOMcom|NOMB.=s|GENRE=f|CAS=r	1	
Lemme : escïent	2	1
essient	1	POS=NOMcom|NOMB.=s|GENRE=m|CAS=r	1	
essïent	1	POS=NOMcom|NOMB.=s|GENRE=m|CAS=r	1	
Lemme : daërrain	1	1
daerrenier	1	POS=ADVgen|DEGRE=-	1	
Lemme : folie2	9	1
folies	1	POS=NOMcom|NOMB.=p|GENRE=f|CAS=r	1	
folie	8	POS=NOMcom|NOMB.=s|GENRE=f|CAS=r	7	POS=NOMcom|NOMB.=s|GENRE=f|CAS=n	1	
Lemme : apareillement	2	1
aparelliement	1	POS=ADVgen|DEGRE=-	1	
apareillemenz	1	POS=NOMcom|NOMB.=p|GENRE=m|CAS=r	1	
Lemme : felon	14	1
felonnies	1	POS=NOMcom|NOMB.=p|GENRE=f|CAS=r	1	
felonesche	1	POS=ADJqua|NOMB.=s|GENRE=f|CAS=n|DEGRE=p	1	
felenesse	1	POS=ADJqua|NOMB.=s|GENRE=f|CAS=r|DEGRE=p	1	
felons	2	POS=ADJqua|NOMB.=p|GENRE=m|CAS=r|DEGRE=p	1	POS=NOMcom|NOMB.=p|GENRE=m|CAS=r	1	
felon	4	POS=ADJqua|NOMB.=s|GENRE=m|CAS=r|DEGRE=p	2	POS=ADJqua|NOMB.=p|GENRE=m|CAS=n|DEGRE=p	2	
fel	5	POS=ADJqua|NOMB.=s|GENRE=m|CAS=n|DEGRE=p	4	POS=ADJqua|NOMB.=p|GENRE=m|CAS=n|DEGRE=p	1	
Lemme : chapitel	1	1
chapitiel	1	POS=NOMcom|NOMB.=s|GENRE=m|CAS=r	1	
Lemme : crïator	2	1
crieres	1	POS=NOMcom|NOMB.=s|GENRE=m|CAS=n	1	
creatour	1	POS=NOMcom|NOMB.=s|GENRE=m|CAS=r	1	
Lemme : quinzime	1	1
quinzieme	1	POS=ADJord|NOMB.=s|GENRE=m|CAS=r	1	
Lemme : trentisme	3	1
trentime	1	POS=ADJord|NOMB.=s|GENRE=m|CAS=r	1	
trentiesme	1	POS=ADJord|NOMB.=s|GENRE=m|CAS=r	1	
trentisme	1	POS=ADJord|NOMB.=s|GENRE=m|CAS=r	1	
Lemme : beste	37	1
bieste	1	POS=NOMcom|NOMB.=s|GENRE=f|CAS=n	1	
bestes	9	POS=NOMcom|NOMB.=p|GENRE=f|CAS=r	8	POS=NOMcom|NOMB.=p|GENRE=f|CAS=n	1	
beste	27	POS=NOMcom|NOMB.=s|GENRE=f|CAS=n	12	POS=NOMcom|NOMB.=s|GENRE=f|CAS=r	15	
Lemme : novele	18	1
noviele	1	POS=NOMcom|NOMB.=s|GENRE=f|CAS=n	1	
noveles	8	POS=NOMcom|NOMB.=p|GENRE=f|CAS=r	8	
novele	9	POS=NOMcom|NOMB.=s|GENRE=f|CAS=n	4	POS=NOMcom|NOMB.=s|GENRE=f|CAS=r	5	
Lemme : haitieement	1	1
heitiement	1	POS=ADVgen|DEGRE=-	1	
Lemme : tel	177	1
atieus	1	POS=PROind|NOMB.=s|GENRE=m|CAS=r	1	
tieuz	1	POS=ADJqua|NOMB.=s|GENRE=m|CAS=n|DEGRE=p	1	
tiels	1	POS=DETind|NOMB.=p|GENRE=f|CAS=r	1	
teus	1	POS=DETind|NOMB.=p|GENRE=f|CAS=r	1	
teil	3	POS=DETind|NOMB.=s|GENRE=f|CAS=n	1	POS=DETind|NOMB.=s|GENRE=m|CAS=r	1	POS=DETind|NOMB.=s|GENRE=f|CAS=r	1	
teles	7	POS=ADJind|NOMB.=p|GENRE=f|CAS=r	2	POS=DETind|NOMB.=p|GENRE=f|CAS=r	5	
tieus	28	POS=DETind|NOMB.=p|GENRE=m|CAS=r	6	POS=DETind|NOMB.=s|GENRE=f|CAS=n	1	POS=DETind|NOMB.=p|GENRE=f|CAS=r	16	POS=PROind|NOMB.=s|GENRE=m|CAS=n	2	POS=DETind|NOMB.=s|GENRE=m|CAS=n	1	POS=DETind|NOMB.=p|GENRE=f|CAS=n	1	POS=PROind|NOMB.=p|GENRE=m|CAS=n	1	
tele	32	POS=DETind|NOMB.=s|GENRE=f|CAS=r	19	POS=ADJind|NOMB.=s|GENRE=f|CAS=r	7	POS=ADJind|NOMB.=s|GENRE=f|CAS=n	4	POS=PROind|NOMB.=s|GENRE=f|CAS=n	1	POS=PROind|NOMB.=s|GENRE=f|CAS=r	1	
tel	103	POS=DETind|NOMB.=s|GENRE=f|CAS=r	86	POS=DETind|NOMB.=s|GENRE=m|CAS=r	17	
Lemme : eustache	1	1
eustochies	1	POS=NOMpro|NOMB.=s|GENRE=m|CAS=n	1	
Lemme : conseillëor	1	1
conseillieres	1	POS=NOMcom|NOMB.=s|GENRE=m|CAS=n	1	
Lemme : etiope	1	1
ethyopiens	1	POS=NOMcom|NOMB.=s|GENRE=m|CAS=n	1	
Lemme : engignior	1	1
engignieres	1	POS=NOMpro|NOMB.=s|GENRE=m|CAS=n	1	
Lemme : destruisëor	1	1
destruisieres	1	POS=NOMcom|NOMB.=s|GENRE=m|CAS=n	1	
Lemme : guerredonëor	1	1
guerredonieres	1	POS=NOMcom|NOMB.=s|GENRE=m|CAS=n	1	
Lemme : dedïement	1	1
dediement	1	POS=NOMcom|NOMB.=s|GENRE=m|CAS=r	1	
Lemme : sapïence	1	1
sapience	1	POS=NOMcom|NOMB.=s|GENRE=f|CAS=r	1	
Lemme : defendëor	4	1
deffenderres	1	POS=NOMcom|NOMB.=s|GENRE=m|CAS=n	1	
deffendierres	1	POS=NOMcom|NOMB.=s|GENRE=m|CAS=n	1	
deffendeur	1	POS=NOMcom|NOMB.=s|GENRE=m|CAS=r	1	
desfenderres	1	POS=NOMcom|NOMB.=s|GENRE=m|CAS=n	1	
Lemme : deserte2	1	1
desierte	1	POS=NOMcom|NOMB.=s|GENRE=f|CAS=r	1	
Lemme : seignorie	29	1
signories	1	POS=NOMcom|NOMB.=p|GENRE=f|CAS=r	1	
segnorie	2	POS=NOMcom|NOMB.=s|GENRE=f|CAS=r	2	
seignorie	4	POS=NOMcom|NOMB.=s|GENRE=f|CAS=r	4	
signorie	22	POS=NOMcom|NOMB.=s|GENRE=f|CAS=r	22	
Lemme : berçuèl	1	1
bierçuel	1	POS=NOMcom|NOMB.=s|GENRE=m|CAS=r	1	
Lemme : mercredi	3	1
miercredi	1	POS=NOMcom|NOMB.=s|GENRE=m|CAS=r	1	
mercredi	2	POS=NOMcom|NOMB.=s|GENRE=m|CAS=r	2	
Lemme : briément	1	1
briement	1	POS=ADVgen|DEGRE=-	1	
Lemme : michel	1	1
michiel	1	POS=NOMpro|NOMB.=s|GENRE=m|CAS=r	1	
Lemme : fontenele	3	1
fontenieles	1	POS=NOMcom|NOMB.=p|GENRE=f|CAS=n	1	
fontenele	2	POS=NOMcom|NOMB.=s|GENRE=f|CAS=r	2	
Lemme : boisëor	1	1
boisieres	1	POS=NOMcom|NOMB.=s|GENRE=m|CAS=n	1	
Lemme : crestïenté	1	1
crestienté	1	POS=NOMcom|NOMB.=s|GENRE=f|CAS=r	1	
Lemme : changëor	2	1
changieres	1	POS=NOMcom|NOMB.=s|GENRE=m|CAS=n	1	
changeur	1	POS=NOMcom|NOMB.=s|GENRE=m|CAS=r	1	
Lemme : vieillart	1	1
viellarz	1	POS=NOMcom|NOMB.=p|GENRE=m|CAS=n	1	
Lemme : set	1	1
siet	1	POS=PROcar|NOMB.=p|GENRE=m|CAS=r	1	
Lemme : uiti(s)me	1	1
huitieves	1	POS=NOMcom|NOMB.=p|GENRE=f|CAS=r	1	
Lemme : congié	17	1
congiez	1	POS=NOMcom|NOMB.=s|GENRE=m|CAS=n	1	
congié	16	POS=NOMcom|NOMB.=s|GENRE=m|CAS=r	16	
Lemme : devorëor	1	1
devorrieres	1	POS=NOMcom|NOMB.=s|GENRE=m|CAS=n	1	
Lemme : maisniee	25	1
mesnies	1	POS=NOMcom|NOMB.=p|GENRE=f|CAS=r	1	
mesnie	24	POS=NOMcom|NOMB.=s|GENRE=f|CAS=r	17	POS=NOMcom|NOMB.=s|GENRE=f|CAS=n	7	
Lemme : nacele	3	1
naciele	1	POS=NOMcom|NOMB.=s|GENRE=f|CAS=r	1	
nacele	2	POS=NOMcom|NOMB.=s|GENRE=f|CAS=r	2	
Lemme : clergié	3	1
clergiés	1	POS=NOMcom|NOMB.=s|GENRE=m|CAS=n	1	
clergié	1	POS=NOMcom|NOMB.=s|GENRE=m|CAS=r	1	
clergiez	1	POS=NOMcom|NOMB.=s|GENRE=m|CAS=n	1	
Lemme : ancïenement	1	1
ancienement	1	POS=ADVgen|DEGRE=-	1	
Lemme : inobedïence	1	1
inobedience	1	POS=NOMcom|NOMB.=s|GENRE=f|CAS=r	1	
Lemme : hardïement	2	2
hardiement	2	POS=ADVgen|DEGRE=-	1	POS=ADVgen|DEGRE=p	1	
Lemme : haitement	2	2
heitiement	2	POS=ADVgen|DEGRE=-	1	POS=ADVgen|DEGRE=c	1	
Lemme : tuen	3	2
tiens	1	POS=PROpos|PERS.=2|NOMB.=p|GENRE=m|CAS=r	1	
tuens	1	POS=PROpos|PERS.=2|NOMB.=p|GENRE=m|CAS=r	1	
tien	1	POS=PROpos|PERS.=2|NOMB.=s|GENRE=m|CAS=n	1	
Lemme : iver2	3	2
yvier	1	POS=NOMcom|NOMB.=s|GENRE=m|CAS=r	1	
yver	1	POS=NOMcom|NOMB.=s|GENRE=m|CAS=r	1	
ivier	1	POS=NOMcom|NOMB.=s|GENRE=m|CAS=n	1	
Lemme : mïete	2	2
mietes	2	POS=NOMcom|NOMB.=p|GENRE=f|CAS=r	2	
Lemme : septe	2	2
septiesme	1	POS=ADJord|NOMB.=s|GENRE=m|CAS=r	1	
septieme	1	POS=NOMcom|NOMB.=s|GENRE=m|CAS=r	1	
Lemme : jugëor	3	2
jucheor	1	POS=NOMcom|NOMB.=s|GENRE=m|CAS=r	1	
jugieres	2	POS=NOMcom|NOMB.=s|GENRE=m|CAS=n	2	
Lemme : medecine	3	2
medecines	1	POS=NOMcom|NOMB.=p|GENRE=f|CAS=r	1	
miedecine	2	POS=NOMcom|NOMB.=s|GENRE=f|CAS=r	2	
Lemme : albanie	2	2
albanies	2	POS=NOMpro|NOMB.=s|GENRE=m|CAS=r	1	POS=NOMpro|NOMB.=s|GENRE=m|CAS=n	1	
Lemme : vieillece	2	2
viellece	2	POS=NOMcom|NOMB.=s|GENRE=f|CAS=r	2	
Lemme : archadés	10	2
archadies	2	POS=NOMpro|NOMB.=s|GENRE=m|CAS=n	2	
archade	3	POS=NOMpro|NOMB.=s|GENRE=m|CAS=r	2	POS=NOMpro|NOMB.=s|GENRE=m|CAS=n	1	
archades	5	POS=NOMpro|NOMB.=s|GENRE=m|CAS=n	5	
Lemme : tonel	5	2
toniaus	1	POS=NOMcom|NOMB.=s|GENRE=m|CAS=n	1	
toniel	2	POS=NOMcom|NOMB.=s|GENRE=m|CAS=r	2	
tonel	2	POS=NOMcom|NOMB.=s|GENRE=m|CAS=r	2	
Lemme : lïon	32	2
liens	2	POS=NOMcom|NOMB.=p|GENRE=m|CAS=r	2	
lionesse	3	POS=NOMcom|NOMB.=s|GENRE=f|CAS=r	1	POS=NOMcom|NOMB.=s|GENRE=f|CAS=n	2	
lion	9	POS=NOMcom|NOMB.=s|GENRE=m|CAS=r	9	
lions	18	POS=NOMcom|NOMB.=s|GENRE=m|CAS=n	18	
Lemme : aideor	3	3
aidieres	1	POS=NOMcom|NOMB.=s|GENRE=m|CAS=r	1	
aidierres	2	POS=NOMcom|NOMB.=s|GENRE=m|CAS=n	2	
Lemme : tesmoin	13	3
tesmoinz	1	POS=NOMcom|NOMB.=p|GENRE=m|CAS=r	1	
tesmoins	2	POS=NOMcom|NOMB.=p|GENRE=m|CAS=r	1	POS=NOMcom|NOMB.=s|GENRE=m|CAS=r	1	
tiesmoing	3	POS=NOMcom|NOMB.=s|GENRE=m|CAS=r	2	POS=NOMcom|NOMB.=s|GENRE=m|CAS=n	1	
tesmoing	7	POS=NOMcom|NOMB.=s|GENRE=m|CAS=r	5	POS=NOMcom|NOMB.=p|GENRE=m|CAS=r	1	POS=NOMcom|NOMB.=s|GENRE=m|CAS=n	1	
Lemme : près	49	3
pries	3	POS=ADVgen|DEGRE=-	3	
pres	46	POS=ADVgen|DEGRE=-	46	
Lemme : ier	5	3
ier	2	POS=ADVgen|DEGRE=-	2	
hier	3	POS=ADVgen|DEGRE=-	3	
Lemme : tenebre	3	3
teniebres	3	POS=NOMcom|NOMB.=p|GENRE=f|CAS=n	1	POS=NOMcom|NOMB.=p|GENRE=f|CAS=r	2	
Lemme : maladie	16	3
maladies	3	POS=NOMcom|NOMB.=p|GENRE=f|CAS=r	3	
maladie	13	POS=NOMcom|NOMB.=s|GENRE=f|CAS=n	1	POS=NOMcom|NOMB.=s|GENRE=f|CAS=r	12	
Lemme : pechëor	6	3
pecheor	1	POS=NOMcom|NOMB.=s|GENRE=m|CAS=r	1	
pecheors	2	POS=NOMcom|NOMB.=p|GENRE=m|CAS=n	2	
pechierres	3	POS=NOMcom|NOMB.=s|GENRE=m|CAS=n	3	
Lemme : lepros	5	3
lyepreus	2	POS=NOMcom|NOMB.=s|GENRE=m|CAS=n	2	
liepreus	3	POS=ADJqua|NOMB.=s|GENRE=m|CAS=n|DEGRE=p	1	POS=NOMcom|NOMB.=p|GENRE=m|CAS=n	1	POS=ADJqua|NOMB.=p|GENRE=m|CAS=r|DEGRE=s	1	
Lemme : disime	3	3
disieme	3	POS=ADJord|NOMB.=s|GENRE=m|CAS=r	3	
Lemme : ortie	3	3
orties	3	POS=NOMcom|NOMB.=s|GENRE=f|CAS=r	1	POS=NOMcom|NOMB.=p|GENRE=f|CAS=r	2	
Lemme : däerrain	16	4
daerrenieres	1	POS=ADJqua|NOMB.=p|GENRE=f|CAS=r|DEGRE=p	1	
daerriene	1	POS=ADJqua|NOMB.=s|GENRE=f|CAS=n|DEGRE=p	1	
daerreinieres	1	POS=ADJqua|NOMB.=p|GENRE=f|CAS=r|DEGRE=p	1	
daerraines	1	POS=ADJqua|NOMB.=p|GENRE=f|CAS=r|DEGRE=p	1	
daerreines	1	POS=ADJqua|NOMB.=p|GENRE=f|CAS=r|DEGRE=p	1	
daerrenier	1	POS=ADJord|NOMB.=s|GENRE=m|CAS=r	1	
daerrain	1	POS=NOMcom|NOMB.=s|GENRE=m|CAS=r	1	
daerreine	2	POS=ADJqua|NOMB.=s|GENRE=f|CAS=n|DEGRE=p	2	
daerrein	7	POS=ADVgen|DEGRE=-	1	POS=ADJqua|NOMB.=s|GENRE=m|CAS=r|DEGRE=p	5	POS=NOMcom|NOMB.=s|GENRE=m|CAS=r|DEGRE=p	1	
Lemme : nïent	42	5
nient	5	POS=NOMcom|NOMB.=s|GENRE=n|CAS=r	2	POS=ADVneg	3	
noient	37	POS=NOMcom|NOMB.=s|GENRE=n|CAS=r	2	POS=ADVneg|MORPH=empty	10	POS=NOMcom|NOMB.=s|GENRE=f|CAS=r	3	POS=NOMcom|NOMB.=s|GENRE=f|CAS=n	1	POS=NOMcom|NOMB.=s|GENRE=m|CAS=n	2	POS=ADVneg	17	POS=PROind|NOMB.=s|GENRE=n|CAS=r	2	
Lemme : lïement	5	5
liement	5	POS=ADVgen|DEGRE=-	2	POS=ADVgen|DEGRE=s	3	
Lemme : engin	7	5
engiens	2	POS=NOMcom|NOMB.=p|GENRE=m|CAS=r	1	POS=NOMcom|NOMB.=s|GENRE=m|CAS=n	1	
engins	2	POS=NOMcom|NOMB.=s|GENRE=m|CAS=n	2	
engien	3	POS=NOMcom|NOMB.=s|GENRE=m|CAS=r	3	
Lemme : aurelius	5	5
aureliens	2	POS=NOMpro|NOMB.=s|GENRE=m|CAS=r	1	POS=NOMpro|NOMB.=s|GENRE=m|CAS=n	1	
aurelien	3	POS=NOMpro|NOMB.=s|GENRE=m|CAS=r	3	
Lemme : compagnie	68	6
conpagnie	1	POS=NOMcom|NOMB.=s|GENRE=f|CAS=r	1	
conpaignies	1	POS=NOMcom|NOMB.=p|GENRE=f|CAS=r	1	
compaigniez	1	POS=NOMcom|NOMB.=p|GENRE=f|CAS=r	1	
compagnie	1	POS=NOMcom|NOMB.=s|GENRE=f|CAS=r	1	
compaignies	4	POS=NOMcom|NOMB.=p|GENRE=f|CAS=n	1	POS=NOMcom|NOMB.=p|GENRE=f|CAS=r	3	
conpaignie	5	POS=NOMcom|NOMB.=s|GENRE=f|CAS=r	5	
compaignie	55	POS=NOMcom|NOMB.=s|GENRE=f|CAS=r	53	POS=NOMcom|NOMB.=s|GENRE=f|CAS=n	2	
Lemme : pacïence	7	7
pacience	7	POS=NOMcom|NOMB.=s|GENRE=f|CAS=r	6	POS=NOMcom|NOMB.=s|GENRE=f|CAS=n	1	
Lemme : felonie	32	7
felonies	7	POS=NOMcom|NOMB.=p|GENRE=f|CAS=r	7	
felonie	25	POS=NOMcom|NOMB.=s|GENRE=f|CAS=r	23	POS=ADJqua|NOMB.=s|GENRE=f|CAS=r|DEGRE=p	1	POS=NOMcom|NOMB.=s|GENRE=f|CAS=n	1	
Lemme : suen	20	7
soie	2	POS=ADJpos|PERS.=3|NOMB.=s|GENRE=f|CAS=r	2	
siens	2	POS=ADJpos|PERS.=3|NOMB.=s|GENRE=m|CAS=n	2	
siue	2	POS=ADJpos|PERS.=3|NOMB.=s|GENRE=f|CAS=r	2	
seue	3	POS=PROpos|PERS.=3|NOMB.=s|GENRE=f|CAS=r	2	POS=ADJpos|PERS.=3|NOMB.=s|GENRE=f|CAS=r	1	
sien	5	POS=ADJpos|PERS.=3|NOMB.=s|GENRE=m|CAS=r	5	
suen	6	POS=ADJpos|PERS.=3|NOMB.=s|GENRE=m|CAS=r	5	POS=PROpos|PERS.=3|NOMB.=s|GENRE=m|CAS=r	1	
Lemme : grevement	7	7
griefment	2	POS=ADVgen|DEGRE=-	1	POS=ADVgen|DEGRE=s	1	
griement	5	POS=ADVgen|DEGRE=-	3	POS=ADVgen|DEGRE=s	2	
Lemme : scïence	8	8
science	8	POS=NOMcom|NOMB.=s|GENRE=f|CAS=r	8	
Lemme : mïenuit	8	8
mienuit	8	POS=NOMcom|NOMB.=s|GENRE=f|CAS=r	7	POS=NOMcom|NOMB.=s|GENRE=m|CAS=r	1	
Lemme : dïemanche	8	8
diemence	8	POS=NOMcom|NOMB.=s|GENRE=m|CAS=r	8	
Lemme : vie1	220	9
vies	9	POS=NOMcom|NOMB.=p|GENRE=f|CAS=r	9	
vie	211	POS=NOMcom|NOMB.=s|GENRE=f|CAS=r	206	POS=NOMcom|NOMB.=s|GENRE=f|CAS=n	5	
Lemme : celestïal	11	9
celestieles	1	POS=ADJqua|NOMB.=p|GENRE=f|CAS=r|DEGRE=p	1	
celestieus	2	POS=ADJqua|NOMB.=p|GENRE=f|CAS=n|DEGRE=p	1	POS=ADJqua|NOMB.=p|GENRE=f|CAS=r|DEGRE=p	1	
celestiel	8	POS=ADJqua|NOMB.=s|GENRE=f|CAS=r|DEGRE=p	3	POS=ADJqua|NOMB.=s|GENRE=m|CAS=r|DEGRE=p	5	
Lemme : orïent	10	10
orient	10	POS=NOMpro|NOMB.=s|GENRE=m|CAS=r	10	
Lemme : isnelement	26	11
isnielement	11	POS=ADVgen|DEGRE=-	8	POS=ADVgen|DEGRE=s	3	
isnelement	15	POS=ADVgen|DEGRE=-	11	POS=ADVgen|DEGRE=s	4	
Lemme : eufamianus	21	11
eufimianus	1	POS=NOMpro|NOMB.=s|GENRE=m|CAS=n	1	
eufamianus	2	POS=NOMpro|NOMB.=s|GENRE=m|CAS=n	2	
eufemien	5	POS=NOMpro|NOMB.=s|GENRE=m|CAS=r	5	
eufemiens	6	POS=NOMpro|NOMB.=s|GENRE=m|CAS=n	6	
eufemianus	7	POS=NOMpro|NOMB.=s|GENRE=m|CAS=n	7	
Lemme : terrïen	12	12
terriens	1	POS=ADJqua|NOMB.=p|GENRE=m|CAS=r|DEGRE=p	1	
terrienes	2	POS=ADJqua|NOMB.=p|GENRE=f|CAS=r|DEGRE=p	2	
terrien	4	POS=ADJqua|NOMB.=s|GENRE=m|CAS=r|DEGRE=p	4	
terriene	5	POS=ADJqua|NOMB.=s|GENRE=f|CAS=r|DEGRE=p	4	POS=ADJqua|NOMB.=s|GENRE=f|CAS=n|DEGRE=p	1	
Lemme : mieus	17	13
mius	2	POS=ADVgen|DEGRE=c	2	
miuz	2	POS=ADVgen|DEGRE=c	1	POS=ADVgen|DEGRE=-	1	
mielz	13	POS=ADVgen|DEGRE=c	13	
Lemme : obedïence	15	15
obediences	1	POS=NOMcom|NOMB.=p|GENRE=f|CAS=r	1	
obedience	14	POS=NOMcom|NOMB.=s|GENRE=f|CAS=r	14	
Lemme : pechié	31	16
pechiet	1	POS=NOMcom|NOMB.=s|GENRE=m|CAS=r	1	
pechiés	5	POS=NOMcom|NOMB.=p|GENRE=m|CAS=r	4	POS=NOMcom|NOMB.=s|GENRE=m|CAS=n	1	
pechié	10	POS=NOMcom|NOMB.=s|GENRE=m|CAS=r	10	
pechiez	15	POS=NOMcom|NOMB.=p|GENRE=m|CAS=r	14	POS=NOMcom|NOMB.=s|GENRE=m|CAS=n	1	
Lemme : partie	48	16
﻿parties	1	POS=NOMcom|NOMB.=p|GENRE=f|CAS=r	1	
﻿partie	2	POS=NOMcom|NOMB.=s|GENRE=f|CAS=r	2	
parties	15	POS=NOMcom|NOMB.=p|GENRE=f|CAS=r	12	POS=NOMcom|NOMB.=p|GENRE=f|CAS=n	1	POS=NOMcom|NOMB.=s|GENRE=f|CAS=r	2	
partie	30	POS=NOMcom|NOMB.=s|GENRE=f|CAS=r	28	POS=NOMcom|NOMB.=s|GENRE=f|CAS=n	2	
Lemme : vieil	25	24
vius	1	POS=ADJqua|NOMB.=p|GENRE=f|CAS=n|DEGRE=p	1	
viels	1	POS=ADJqua|NOMB.=s|GENRE=m|CAS=n|DEGRE=p	1	
viez	3	POS=ADJqua|NOMB.=s|GENRE=f|CAS=r|DEGRE=p	1	POS=ADJqua|NOMB.=s|GENRE=m|CAS=r|DEGRE=p	1	POS=ADJqua|NOMB.=p|GENRE=f|CAS=r|DEGRE=p	1	
vielz	9	POS=ADJqua|NOMB.=s|GENRE=m|CAS=n|DEGRE=p	7	POS=ADJqua|NOMB.=p|GENRE=m|CAS=r|DEGRE=p	1	POS=ADJqua|NOMB.=s|GENRE=m|CAS=n|DEGRE=s	1	
viel	11	POS=ADJqua|NOMB.=p|GENRE=m|CAS=n|DEGRE=p	3	POS=ADJqua|NOMB.=s|GENRE=m|CAS=r|DEGRE=p	8	
Lemme : lié1	35	28
liés	1	POS=ADJqua|NOMB.=s|GENRE=m|CAS=n|DEGRE=p	1	
lié	2	POS=ADJqua|NOMB.=s|GENRE=m|CAS=r|DEGRE=p	1	POS=ADJqua|NOMB.=p|GENRE=m|CAS=n|DEGRE=p	1	
lie	4	POS=ADJqua|NOMB.=s|GENRE=f|CAS=n|DEGRE=p	3	POS=ADJqua|NOMB.=s|GENRE=f|CAS=n|DEGRE=c	1	
liez	28	POS=ADJqua|NOMB.=s|GENRE=m|CAS=n|DEGRE=p	18	POS=ADJqua|NOMB.=s|GENRE=m|CAS=n|DEGRE=c	2	POS=ADJqua|NOMB.=s|GENRE=m|CAS=n|DEGRE=s	6	POS=ADJqua|NOMB.=p|GENRE=m|CAS=n|DEGRE=p	2	
Lemme : pié	79	68
﻿piez	1	POS=NOMcom|NOMB.=p|GENRE=m|CAS=r	1	
pié	11	POS=NOMcom|NOMB.=s|GENRE=m|CAS=r	10	POS=NOMcom|NOMB.=p|GENRE=m|CAS=n	1	
piez	67	POS=NOMcom|NOMB.=p|GENRE=m|CAS=r	67	

Graphie du mot près

lemme : près	Nombres d'occurrences : 49
pries	3	POS=ADVgen|DEGRE=-	3	


Graphie du mot après

lemme : après	Nombres d'occurrences : 176
pries	3	POS=ADVgen|DEGRE=-	3	

Graphie du mot apeler

lemme : apeler	Nombres d'occurrences : 108
pries	3	POS=ADVgen|DEGRE=-	3	


Graphie du mot arester

lemme : arester	Nombres d'occurrences : 48
pries	3	POS=ADVgen|DEGRE=-	3	

§12.1 ellus/os > eaus > iaus

Mot	Nombres d'occurrences total	Nombre d'occurrences
Lemme : jovencel	69	1
jovenciaus	1	POS=NOMcom|NOMB.=s|GENRE=m|CAS=n	1	
jovenencel	1	POS=NOMcom|NOMB.=p|GENRE=m|CAS=n	1	
jovencel	15	POS=NOMcom|NOMB.=p|GENRE=m|CAS=n	1	POS=NOMcom|NOMB.=s|GENRE=m|CAS=r	14	
jovenceaus	52	POS=NOMcom|NOMB.=s|GENRE=m|CAS=n	37	POS=ADJqua|NOMB.=s|GENRE=m|CAS=n|DEGRE=p	3	POS=NOMcom|NOMB.=p|GENRE=m|CAS=r	9	POS=NOMcom|NOMB.=p|GENRE=m|CAS=n	3	
Lemme : poissonel	1	1
pissonniaus	1	POS=NOMcom|NOMB.=p|GENRE=m|CAS=r	1	
Lemme : pel2	4	1
piaus	1	POS=NOMcom|NOMB.=p|GENRE=m|CAS=r	1	
peaus	1	POS=NOMcom|NOMB.=p|GENRE=f|CAS=r	1	
pel	2	POS=NOMcom|NOMB.=s|GENRE=f|CAS=r	2	
Lemme : vercelles	1	1
verziaus	1	POS=NOMpro|NOMB.=s|GENRE=f|CAS=r	1	
Lemme : corbeil	5	1
corbiaus	1	POS=NOMcom|NOMB.=s|GENRE=m|CAS=n	1	
corbeaus	4	POS=NOMcom|NOMB.=s|GENRE=m|CAS=n	4	
Lemme : roial2	7	1
roiaus	1	POS=ADJqua|NOMB.=p|GENRE=f|CAS=r|DEGRE=p	1	
roial	6	POS=ADJqua|NOMB.=s|GENRE=f|CAS=r|DEGRE=p	2	POS=ADJqua|NOMB.=s|GENRE=m|CAS=r|DEGRE=p	4	
Lemme : barillet	1	1
barilliaus	1	POS=NOMcom|NOMB.=p|GENRE=m|CAS=r	1	
Lemme : tonel	5	1
toniaus	1	POS=NOMcom|NOMB.=s|GENRE=m|CAS=n	1	
toniel	2	POS=NOMcom|NOMB.=s|GENRE=m|CAS=r	2	
tonel	2	POS=NOMcom|NOMB.=s|GENRE=m|CAS=r	2	
Lemme : vaissel	33	2
vaisseaus	1	POS=NOMcom|NOMB.=s|GENRE=m|CAS=n	1	
vaissel	2	POS=NOMcom|NOMB.=s|GENRE=m|CAS=r	2	
vessiaus	2	POS=NOMcom|NOMB.=p|GENRE=m|CAS=r	2	
vesseaus	6	POS=NOMcom|NOMB.=p|GENRE=m|CAS=r	1	POS=NOMcom|NOMB.=s|GENRE=m|CAS=n	4	POS=NOMcom|NOMB.=s|GENRE=m|CAS=r	1	
vessel	22	POS=NOMcom|NOMB.=s|GENRE=m|CAS=r	21	POS=NOMcom|NOMB.=p|GENRE=m|CAS=n	1	
Lemme : chastel	40	4
chastiel	1	POS=NOMcom|NOMB.=s|GENRE=m|CAS=r	1	
chastiaus	4	POS=NOMcom|NOMB.=s|GENRE=m|CAS=n	2	POS=NOMcom|NOMB.=p|GENRE=m|CAS=r	2	
chasteaus	5	POS=NOMcom|NOMB.=p|GENRE=m|CAS=r	4	POS=NOMcom|NOMB.=s|GENRE=m|CAS=n	1	
chastel	30	POS=NOMcom|NOMB.=s|GENRE=m|CAS=r	30	
Lemme : bel1	176	7
biau	1	POS=ADJqua|NOMB.=s|GENRE=m|CAS=r|DEGRE=p	1	
biaus	6	POS=ADJqua|NOMB.=s|GENRE=m|CAS=n|DEGRE=p	3	POS=ADJqua|NOMB.=p|GENRE=m|CAS=n|DEGRE=p	3	
bel	9	POS=ADJqua|NOMB.=p|GENRE=m|CAS=r|DEGRE=p	1	POS=ADJqua|NOMB.=s|GENRE=m|CAS=r|DEGRE=p	6	POS=ADJqua|NOMB.=s|GENRE=m|CAS=n|DEGRE=p	2	
bele	21	POS=ADJqua|NOMB.=s|GENRE=f|CAS=r|DEGRE=p	9	POS=ADJqua|NOMB.=s|GENRE=f|CAS=r|DEGRE=s	6	POS=ADJqua|NOMB.=s|GENRE=f|CAS=n|DEGRE=p	5	POS=ADJqua|NOMB.=s|GENRE=f|CAS=n|DEGRE=s	1	
beau	22	POS=ADJqua|NOMB.=s|GENRE=m|CAS=r|DEGRE=p	15	POS=ADJqua|NOMB.=p|GENRE=m|CAS=n|DEGRE=p	4	POS=ADJqua|NOMB.=s|GENRE=m|CAS=r|DEGRE=s	3	
beles	22	POS=ADJqua|NOMB.=p|GENRE=f|CAS=r|DEGRE=p	17	POS=ADJqua|NOMB.=p|GENRE=f|CAS=n|DEGRE=p	4	POS=ADJqua|NOMB.=p|GENRE=f|CAS=n|DEGRE=c	1	
beaus	95	POS=ADJqua|NOMB.=s|GENRE=m|CAS=n|DEGRE=p	73	POS=ADJqua|NOMB.=p|GENRE=m|CAS=n|DEGRE=p	13	POS=ADJqua|NOMB.=p|GENRE=m|CAS=r|DEGRE=p	6	POS=ADJqua|NOMB.=s|GENRE=m|CAS=n|DEGRE=s	3	

§12.1 illus > aus

Mot	Nombres d'occurrences total	Nombre d'occurrences
Lemme : conseil	13	1
conseus	1	POS=NOMcom|NOMB.=p|GENRE=m|CAS=r	1	
consauz	1	POS=NOMcom|NOMB.=p|GENRE=m|CAS=r	1	
conselle	1	POS=NOMcom|NOMB.=s|GENRE=m|CAS=r	1	
conseuz	1	POS=NOMcom|NOMB.=p|GENRE=m|CAS=r	1	
consel	2	POS=NOMcom|NOMB.=s|GENRE=m|CAS=r	2	
conseil	7	POS=NOMcom|NOMB.=s|GENRE=m|CAS=r	7	
Lemme : soleil	10	2
soleuz	1	POS=NOMcom|NOMB.=s|GENRE=m|CAS=n	1	
solauz	2	POS=NOMcom|NOMB.=s|GENRE=m|CAS=n	2	
soleil	7	POS=NOMcom|NOMB.=s|GENRE=m|CAS=r	7	
Lemme : corbeil	5	5
corbiaus	1	POS=NOMcom|NOMB.=s|GENRE=m|CAS=n	1	
corbeaus	4	POS=NOMcom|NOMB.=s|GENRE=m|CAS=n	4	


§12.3 Etude de la graphie du pronom P3 - pluriel régime

lemme : il	Nombres d'occurrences : 6629
elles	1	POS=PROper|PERS.=3|NOMB.=p|GENRE=f|CAS=i	1	
l	1	POS=PROper|PERS.=3|NOMB.=p|GENRE=m|CAS=r	1	
eles	4	POS=PROper|PERS.=3|NOMB.=p|GENRE=f|CAS=i	4	
euz	4	POS=PROper|PERS.=3|NOMB.=p|GENRE=m|CAS=r	1	POS=PROper|PERS.=3|NOMB.=p|GENRE=m|CAS=i	3	
els	6	POS=PROper|PERS.=3|NOMB.=p|GENRE=m|CAS=i	6	
li	9	POS=PROper|PERS.=3|NOMB.=p|GENRE=m|CAS=i	9	
leur	11	POS=PROper|PERS.=3|NOMB.=p|GENRE=m|CAS=i	10	POS=PROper|PERS.=3|NOMB.=p|GENRE=f|CAS=i	1	
eus	113	POS=PROper|PERS.=3|NOMB.=p|GENRE=m|CAS=i	113	
les	231	POS=PROper|PERS.=3|NOMB.=p|GENRE=m|CAS=r	190	POS=PROper|PERS.=3|NOMB.=p|GENRE=f|CAS=r	41	
lor	248	POS=PROper|PERS.=3|NOMB.=p|GENRE=m|CAS=i	241	POS=PROper|PERS.=3|NOMB.=p|GENRE=f|CAS=i	5	POS=PROper|PERS.=3|NOMB.=p|GENRE=f|CAS=r	2	


§14 melius < mius
lemme : mieus	Nombres d'occurrences : 17
mius	2	POS=ADVgen|DEGRE=c	2	
miuz	2	POS=ADVgen|DEGRE=c	1	POS=ADVgen|DEGRE=-	1	
mielz	13	POS=ADVgen|DEGRE=c	13	


Confusion graphique an/en $15
mots en en

Mot	Nombres d'occurrences total	Nombre d'occurrences
Lemme : atemprance	1	1
atemprance	1	POS=NOMcom|NOMB.=s|GENRE=f|CAS=r	1	
Lemme : frenge	1	1
frange	1	POS=NOMcom|NOMB.=s|GENRE=f|CAS=r	1	
Lemme : semblable	2	1
samblables	1	POS=ADJqua|NOMB.=s|GENRE=m|CAS=n|DEGRE=p	1	
semblable	1	POS=ADJqua|NOMB.=s|GENRE=f|CAS=n|DEGRE=p	1	
Lemme : astinence	5	1
abstinance	1	POS=NOMcom|NOMB.=s|GENRE=f|CAS=r	1	
abstinences	1	POS=NOMcom|NOMB.=p|GENRE=f|CAS=r	1	
abstinence	3	POS=NOMcom|NOMB.=s|GENRE=f|CAS=r	3	
Lemme : granement	1	1
granment	1	POS=ADVgen|DEGRE=-	1	
Lemme : dessemblable	1	1
dessamblables	1	POS=ADJqua|NOMB.=s|GENRE=m|CAS=n|DEGRE=p	1	
Lemme : sanglent	1	1
sanglenz	1	POS=ADJqua|NOMB.=s|GENRE=m|CAS=n|DEGRE=p	1	
Lemme : ensivance	1	1
ensivance	1	POS=NOMcom|NOMB.=s|GENRE=f|CAS=r	1	
Lemme : enchantëor	1	1
enchanteresses	1	POS=NOMcom|NOMB.=p|GENRE=f|CAS=r|DEGRE=p	1	
Lemme : enchantement	1	1
enchantement	1	POS=NOMcom|NOMB.=p|GENRE=m|CAS=n	1	
Lemme : ancïenement	1	1
ancienement	1	POS=ADVgen|DEGRE=-	1	
Lemme : enfançon	1	1
enfançon	1	POS=NOMcom|NOMB.=s|GENRE=m|CAS=r	1	
Lemme : abondanment	1	1
habundanment	1	POS=ADVgen|DEGRE=-	1	
Lemme : ofrende	3	2
offrendes	1	POS=NOMcom|NOMB.=p|GENRE=f|CAS=r	1	
offrandes	2	POS=NOMcom|NOMB.=p|GENRE=f|CAS=r	2	
Lemme : assemblee	5	2
assamblee	2	POS=NOMcom|NOMB.=s|GENRE=f|CAS=r	2	
assemblee	3	POS=NOMcom|NOMB.=s|GENRE=f|CAS=r	3	
Lemme : penitence	2	2
penitance	2	POS=NOMcom|NOMB.=s|GENRE=f|CAS=r	2	
Lemme : enchanterie	2	2
enchanterie	2	POS=NOMcom|NOMB.=s|GENRE=f|CAS=r	2	
Lemme : granment	2	2
gramnent	1	POS=ADVgen|DEGRE=-	1	
granment	1	POS=ADVgen|DEGRE=-	1	
Lemme : remembrance	2	2
ramembrance	2	POS=NOMcom|NOMB.=s|GENRE=f|CAS=r	1	POS=NOMcom|NOMB.=s|GENRE=f|CAS=n	1	
Lemme : mandement	3	3
mandemenz	1	POS=NOMcom|NOMB.=p|GENRE=m|CAS=r	1	
mandement	2	POS=NOMcom|NOMB.=s|GENRE=m|CAS=r	2	
Lemme : venjance	4	4
venjance	4	POS=NOMcom|NOMB.=s|GENRE=f|CAS=r	4	
Lemme : enfance	7	7
enfances	1	POS=NOMcom|NOMB.=p|GENRE=f|CAS=r	1	
enfance	6	POS=NOMcom|NOMB.=s|GENRE=f|CAS=r	6	
Lemme : semblant	7	7
semblant	3	POS=NOMcom|NOMB.=s|GENRE=m|CAS=r	3	
samblant	4	POS=NOMcom|NOMB.=s|GENRE=m|CAS=r	4	
Lemme : errement	8	8
erranment	8	POS=ADVgen|DEGRE=-	8	
Lemme : semblance	16	16
semblances	1	POS=NOMcom|NOMB.=p|GENRE=m|CAS=r	1	
samblances	1	POS=NOMcom|NOMB.=p|GENRE=f|CAS=r	1	
sanblance	1	POS=NOMcom|NOMB.=s|GENRE=f|CAS=r	1	
samblance	6	POS=NOMcom|NOMB.=s|GENRE=f|CAS=r	6	
semblance	7	POS=NOMcom|NOMB.=s|GENRE=f|CAS=r	6	POS=NOMcom|NOMB.=s|GENRE=f|CAS=n	1	
Lemme : essemple	24	19
exemples	2	POS=NOMcom|NOMB.=p|GENRE=f|CAS=r	2	
exemple	3	POS=NOMcom|NOMB.=s|GENRE=m|CAS=r	2	POS=NOMcom|NOMB.=p|GENRE=m|CAS=n	1	
examples	6	POS=NOMcom|NOMB.=p|GENRE=m|CAS=r	5	POS=NOMcom|NOMB.=p|GENRE=f|CAS=r	1	
example	13	POS=NOMcom|NOMB.=s|GENRE=m|CAS=r	12	POS=NOMcom|NOMB.=s|GENRE=m|CAS=n	1	
Lemme : enfant	92	49
enfans	1	POS=NOMcom|NOMB.=p|GENRE=m|CAS=r	1	
enfanz	10	POS=NOMcom|NOMB.=p|GENRE=m|CAS=r	8	POS=NOMcom|NOMB.=s|GENRE=m|CAS=r	1	POS=NOMcom|NOMB.=p|GENRE=m|CAS=n	1	
enfant	38	POS=NOMcom|NOMB.=p|GENRE=m|CAS=n	6	POS=NOMcom|NOMB.=s|GENRE=m|CAS=r	32	
enfes	43	POS=NOMcom|NOMB.=s|GENRE=m|CAS=n	43	
Lemme : comandement	49	49
coumandemenz	1	POS=NOMcom|NOMB.=p|GENRE=m|CAS=r	1	
conmandemens	1	POS=NOMcom|NOMB.=s|GENRE=m|CAS=n	1	
coumandement	2	POS=NOMcom|NOMB.=s|GENRE=m|CAS=r	2	
conmandemenz	8	POS=NOMcom|NOMB.=p|GENRE=m|CAS=r	8	
conmandement	11	POS=NOMcom|NOMB.=s|GENRE=m|CAS=r	11	
comandemenz	12	POS=NOMcom|NOMB.=p|GENRE=m|CAS=r	12	
comandement	14	POS=NOMcom|NOMB.=s|GENRE=m|CAS=r	14	
Lemme : ensemble	252	212
ensanble	2	POS=ADVgen|DEGRE=-	2	
ensemble	40	POS=ADVgen|DEGRE=-	40	
ensamble	210	POS=ADVgen|DEGRE=-	206	POS=PRE|MORPH=empty	4	

mots en an

Mot	Nombres d'occurrences total	Nombre d'occurrences
Lemme : atemprance	1	1
atemprance	1	POS=NOMcom|NOMB.=s|GENRE=f|CAS=r	1	
Lemme : covenant	2	1
covenent	1	POS=NOMcom|NOMB.=s|GENRE=m|CAS=r	1	
covenant	1	POS=NOMcom|NOMB.=s|GENRE=m|CAS=r	1	
Lemme : covenance	2	1
covenence	1	POS=NOMcom|NOMB.=s|GENRE=f|CAS=r	1	
covenance	1	POS=NOMcom|NOMB.=s|GENRE=m|CAS=r	1	
Lemme : mangier	85	1
menja	1	POS=VERcjg|MODE=ind|TEMPS=psp|PERS.=3|NOMB.=s	1	
mengoie	1	POS=VERcjg|MODE=ind|TEMPS=ipf|PERS.=1|NOMB.=s	1	
menjames	1	POS=VERcjg|MODE=ind|TEMPS=psp|PERS.=1|NOMB.=p	1	
menjoit	1	POS=VERcjg|MODE=ind|TEMPS=ipf|PERS.=3|NOMB.=s	1	
mengiez	1	POS=VERppe|NOMB.=s|GENRE=m|CAS=n	1	
menguce	1	POS=VERcjg|MODE=sub|TEMPS=pst|PERS.=3|NOMB.=s	1	
mengastes	1	POS=VERcjg|MODE=ind|TEMPS=psp|PERS.=2|NOMB.=p	1	
mengassent	1	POS=VERcjg|MODE=sub|TEMPS=ipf|PERS.=3|NOMB.=p	1	
menjuces	1	POS=VERcjg|MODE=sub|TEMPS=pst|PERS.=2|NOMB.=p	1	
mengeront	1	POS=VERcjg|MODE=ind|TEMPS=fut|PERS.=3|NOMB.=p	1	
mengue	2	POS=VERcjg|MODE=imp|PERS.=2|NOMB.=s	1	POS=VERcjg|MODE=ind|TEMPS=pst|PERS.=3|NOMB.=s	1	
menjoient	2	POS=VERcjg|MODE=con|PERS.=3|NOMB.=p	1	POS=VERcjg|MODE=ind|TEMPS=ipf|PERS.=3|NOMB.=p	1	
mengiers	2	POS=VERinf|NOMB.=p|GENRE=m|CAS=r	2	
mengerai	2	POS=VERcjg|MODE=ind|TEMPS=fut|PERS.=1|NOMB.=s	2	
mengerons	2	POS=VERcjg|MODE=ind|TEMPS=fut|PERS.=1|NOMB.=p	2	
mengast	2	POS=VERcjg|MODE=sub|TEMPS=ipf|PERS.=3|NOMB.=s	2	
mengeroit	3	POS=VERcjg|MODE=con|PERS.=3|NOMB.=s	3	
mengoient	3	POS=VERcjg|MODE=ind|TEMPS=ipf|PERS.=3|NOMB.=p	2	POS=VERcjg|MODE=ind|TEMPS=ipf|PERS.=3|NOMB.=s	1	
menga	5	POS=VERcjg|MODE=ind|TEMPS=psp|PERS.=3|NOMB.=s	5	
mengierent	5	POS=VERcjg|MODE=ind|TEMPS=psp|PERS.=3|NOMB.=p	5	
mengié	8	POS=VERppe|NOMB.=p|GENRE=m|CAS=r	1	POS=VERppe|NOMB.=s|GENRE=n|CAS=r	4	POS=VERppe|NOMB.=s|GENRE=m|CAS=r	3	
mengoit	9	POS=VERcjg|MODE=ind|TEMPS=ipf|PERS.=3|NOMB.=s	9	
mengier	30	POS=VERinf|NOMB.=x|GENRE=x|CAS=x	23	POS=NOMcom|NOMB.=s|GENRE=n|CAS=r	1	POS=VERinf|NOMB.=s|GENRE=m|CAS=r	6	
Lemme : amboise	1	1
embaise	1	POS=NOMpro|NOMB.=s|GENRE=f|CAS=r	1	
Lemme : franc1	2	1
franchement	1	POS=ADVgen|DEGRE=c	1	
frans	1	POS=ADJqua|NOMB.=s|GENRE=m|CAS=n|DEGRE=p	1	
Lemme : sanglent	1	1
sanglenz	1	POS=ADJqua|NOMB.=s|GENRE=m|CAS=n|DEGRE=p	1	
Lemme : ensivance	1	1
ensivance	1	POS=NOMcom|NOMB.=s|GENRE=f|CAS=r	1	
Lemme : enchantëor	1	1
enchanteresses	1	POS=NOMcom|NOMB.=p|GENRE=f|CAS=r|DEGRE=p	1	
Lemme : enchantement	1	1
enchantement	1	POS=NOMcom|NOMB.=p|GENRE=m|CAS=n	1	
Lemme : ancïenement	1	1
ancienement	1	POS=ADVgen|DEGRE=-	1	
Lemme : enfançon	1	1
enfançon	1	POS=NOMcom|NOMB.=s|GENRE=m|CAS=r	1	
Lemme : abondanment	1	1
habundanment	1	POS=ADVgen|DEGRE=-	1	
Lemme : enchanterie	2	2
enchanterie	2	POS=NOMcom|NOMB.=s|GENRE=f|CAS=r	2	
Lemme : granment	2	2
gramnent	1	POS=ADVgen|DEGRE=-	1	
granment	1	POS=ADVgen|DEGRE=-	1	
Lemme : remembrance	2	2
ramembrance	2	POS=NOMcom|NOMB.=s|GENRE=f|CAS=r	1	POS=NOMcom|NOMB.=s|GENRE=f|CAS=n	1	
Lemme : constantinople	4	2
costantinoble	2	POS=NOMpro|NOMB.=s|GENRE=f|CAS=r	1	POS=NOMpro|NOMB.=s|GENRE=m|CAS=r	1	
costentinoble	2	POS=NOMpro|NOMB.=s|GENRE=f|CAS=n	1	POS=NOMpro|NOMB.=s|GENRE=f|CAS=r	1	
Lemme : semblant	7	3
semblant	3	POS=NOMcom|NOMB.=s|GENRE=m|CAS=r	3	
samblant	4	POS=NOMcom|NOMB.=s|GENRE=m|CAS=r	4	
Lemme : mandement	3	3
mandemenz	1	POS=NOMcom|NOMB.=p|GENRE=m|CAS=r	1	
mandement	2	POS=NOMcom|NOMB.=s|GENRE=m|CAS=r	2	
Lemme : constantin	3	3
costentin	3	POS=NOMpro|NOMB.=s|GENRE=m|CAS=n	1	POS=NOMpro|NOMB.=s|GENRE=m|CAS=r	2	
Lemme : anciien	11	4
ancïens	1	POS=NOMcom|NOMB.=p|GENRE=m|CAS=r	1	
ancienes	1	POS=ADJqua|NOMB.=p|GENRE=f|CAS=r|DEGRE=p	1	
anciene	2	POS=ADJqua|NOMB.=s|GENRE=f|CAS=n|DEGRE=p	2	
anciens	3	POS=ADJqua|NOMB.=p|GENRE=m|CAS=r|DEGRE=p	2	POS=ADJqua|NOMB.=p|GENRE=m|CAS=n|DEGRE=p	1	
ancien	4	POS=NOMcom|NOMB.=p|GENRE=m|CAS=n	1	POS=ADJqua|NOMB.=p|GENRE=m|CAS=n|DEGRE=p	1	POS=ADJqua|NOMB.=s|GENRE=m|CAS=r|DEGRE=p	2	
Lemme : venjance	4	4
venjance	4	POS=NOMcom|NOMB.=s|GENRE=f|CAS=r	4	
Lemme : enfance	7	7
enfances	1	POS=NOMcom|NOMB.=p|GENRE=f|CAS=r	1	
enfance	6	POS=NOMcom|NOMB.=s|GENRE=f|CAS=r	6	
Lemme : semblance	16	8
semblances	1	POS=NOMcom|NOMB.=p|GENRE=m|CAS=r	1	
samblances	1	POS=NOMcom|NOMB.=p|GENRE=f|CAS=r	1	
sanblance	1	POS=NOMcom|NOMB.=s|GENRE=f|CAS=r	1	
samblance	6	POS=NOMcom|NOMB.=s|GENRE=f|CAS=r	6	
semblance	7	POS=NOMcom|NOMB.=s|GENRE=f|CAS=r	6	POS=NOMcom|NOMB.=s|GENRE=f|CAS=n	1	
Lemme : dïemanche	8	8
diemence	8	POS=NOMcom|NOMB.=s|GENRE=m|CAS=r	8	
Lemme : comandement	49	49
coumandemenz	1	POS=NOMcom|NOMB.=p|GENRE=m|CAS=r	1	
conmandemens	1	POS=NOMcom|NOMB.=s|GENRE=m|CAS=n	1	
coumandement	2	POS=NOMcom|NOMB.=s|GENRE=m|CAS=r	2	
conmandemenz	8	POS=NOMcom|NOMB.=p|GENRE=m|CAS=r	8	
conmandement	11	POS=NOMcom|NOMB.=s|GENRE=m|CAS=r	11	
comandemenz	12	POS=NOMcom|NOMB.=p|GENRE=m|CAS=r	12	
comandement	14	POS=NOMcom|NOMB.=s|GENRE=m|CAS=r	14	
Lemme : enfant	92	92
enfans	1	POS=NOMcom|NOMB.=p|GENRE=m|CAS=r	1	
enfanz	10	POS=NOMcom|NOMB.=p|GENRE=m|CAS=r	8	POS=NOMcom|NOMB.=s|GENRE=m|CAS=r	1	POS=NOMcom|NOMB.=p|GENRE=m|CAS=n	1	
enfant	38	POS=NOMcom|NOMB.=p|GENRE=m|CAS=n	6	POS=NOMcom|NOMB.=s|GENRE=m|CAS=r	32	
enfes	43	POS=NOMcom|NOMB.=s|GENRE=m|CAS=n	43	



Forme alternantive des infinitifs : seîr, caïr/keïr et veïr $17
veoir (50)
cheïr (2)
cheoir (34)
seoir (5)

-gula > pic. iule $18
Mot	Nombres d'occurrences total	Nombre d'occurrences
Lemme : riule	10	6
regle	1	POS=NOMcom|NOMB.=s|GENRE=m|CAS=r	1	
ruigle	1	POS=NOMcom|NOMB.=s|GENRE=m|CAS=r	1	
ruile	2	POS=NOMcom|NOMB.=s|GENRE=f|CAS=r	2	
riule	6	POS=NOMcom|NOMB.=s|GENRE=f|CAS=r	4	POS=NOMcom|NOMB.=s|GENRE=f|CAS=n	2	

Confusion graphique ain pour ein $19
Mot	Nombres d'occurrences total	Nombre d'occurrences
Lemme : ceindre	2	1
chainte	1	POS=VERppe|NOMB.=s|GENRE=f|CAS=r	1	
ceinstrent	1	POS=VERcjg|MODE=ind|TEMPS=psp|PERS.=3|NOMB.=p	1	
Lemme : serein	1	1
serain	1	POS=NOMcom|NOMB.=s|GENRE=m|CAS=r	1	
Lemme : desdeing	1	1
desdaing	1	POS=NOMcom|NOMB.=s|GENRE=m|CAS=r	1	
Lemme : aleine	1	1
alaine	1	POS=NOMcom|NOMB.=s|GENRE=f|CAS=r	1	
Lemme : chäeine	8	2
chaine	1	POS=NOMcom|NOMB.=s|GENRE=f|CAS=r	1	
chaines	1	POS=NOMcom|NOMB.=p|GENRE=f|CAS=r	1	
chaenes	1	POS=NOMcom|NOMB.=p|GENRE=f|CAS=r	1	
chaïnes	5	POS=NOMcom|NOMB.=p|GENRE=f|CAS=r	5	
Lemme : constreindre	8	2
constreinz	1	POS=VERppe|NOMB.=s|GENRE=m|CAS=n	1	
constrains	1	POS=VERppe|NOMB.=s|GENRE=m|CAS=n	1	
constreinst	1	POS=VERcjg|MODE=ind|TEMPS=psp|PERS.=3|NOMB.=s	1	
constreindre	1	POS=VERinf|NOMB.=x|GENRE=x|CAS=x	1	
constrainz	1	POS=VERppe|NOMB.=s|GENRE=m|CAS=n	1	
constreignoit	1	POS=VERcjg|MODE=ind|TEMPS=ipf|PERS.=3|NOMB.=s	1	
constreint	2	POS=VERcjg|MODE=ind|TEMPS=pst|PERS.=3|NOMB.=s	1	POS=VERppe|NOMB.=p|GENRE=m|CAS=n	1	
Lemme : peindre1	2	2
painte	2	POS=VERppe|NOMB.=s|GENRE=f|CAS=n	1	POS=VERppe|NOMB.=s|GENRE=f|CAS=n|DEGRE=p	1	
Lemme : peine	52	20
peinnes	1	POS=NOMcom|NOMB.=p|GENRE=f|CAS=r	1	
poines	4	POS=NOMcom|NOMB.=p|GENRE=f|CAS=r	4	
peine	7	POS=NOMcom|NOMB.=s|GENRE=f|CAS=r	7	
paine	10	POS=NOMcom|NOMB.=s|GENRE=f|CAS=r	10	
paines	10	POS=NOMcom|NOMB.=p|GENRE=f|CAS=r	7	POS=NOMcom|NOMB.=s|GENRE=f|CAS=r	2	POS=NOMcom|NOMB.=p|GENRE=f|CAS=n	1	
peines	20	POS=NOMcom|NOMB.=p|GENRE=f|CAS=r	15	POS=NOMcom|NOMB.=s|GENRE=f|CAS=r	1	POS=NOMcom|NOMB.=s|GENRE=m|CAS=r	2	POS=ADVgen|DEGRE=-	1	POS=NOMcom|NOMB.=p|GENRE=m|CAS=r	1	

pic. ius, ieus  $20,$21,$25
Mot	Nombres d'occurrences total	Nombre d'occurrences
Lemme : arrius	1	1
arrius	1	POS=NOMpro|NOMB.=s|GENRE=m|CAS=n	1	
Lemme : rurtius	1	1
rurtius	1	POS=NOMpro|NOMB.=s|GENRE=m|CAS=r	1	
Lemme : vieil	25	1
vius	1	POS=ADJqua|NOMB.=p|GENRE=f|CAS=n|DEGRE=p	1	
viels	1	POS=ADJqua|NOMB.=s|GENRE=m|CAS=n|DEGRE=p	1	
viez	3	POS=ADJqua|NOMB.=s|GENRE=f|CAS=r|DEGRE=p	1	POS=ADJqua|NOMB.=s|GENRE=m|CAS=r|DEGRE=p	1	POS=ADJqua|NOMB.=p|GENRE=f|CAS=r|DEGRE=p	1	
vielz	9	POS=ADJqua|NOMB.=s|GENRE=m|CAS=n|DEGRE=p	7	POS=ADJqua|NOMB.=p|GENRE=m|CAS=r|DEGRE=p	1	POS=ADJqua|NOMB.=s|GENRE=m|CAS=n|DEGRE=s	1	
viel	11	POS=ADJqua|NOMB.=p|GENRE=m|CAS=n|DEGRE=p	3	POS=ADJqua|NOMB.=s|GENRE=m|CAS=r|DEGRE=p	8	
Lemme : lidorius	1	1
lidorius	1	POS=NOMpro|NOMB.=s|GENRE=m|CAS=n	1	
Lemme : paulin	3	1
paulins	1	POS=NOMpro|NOMB.=s|GENRE=m|CAS=n	1	
paulius	1	POS=NOMpro|NOMB.=s|GENRE=m|CAS=n	1	
paulin	1	POS=NOMpro|NOMB.=s|GENRE=m|CAS=r	1	
Lemme : euvagius	1	1
euvagius	1	POS=NOMpro|NOMB.=s|GENRE=m|CAS=n	1	
Lemme : andrius	3	1
andrius	1	POS=NOMpro|NOMB.=s|GENRE=m|CAS=n	1	
andriu	2	POS=NOMpro|NOMB.=s|GENRE=m|CAS=r	2	
Lemme : peril	16	1
perius	1	POS=NOMcom|NOMB.=p|GENRE=m|CAS=r	1	
peril	15	POS=NOMcom|NOMB.=s|GENRE=m|CAS=r	15	
Lemme : veredemius	4	1
veredemius	1	POS=NOMpro|NOMB.=s|GENRE=m|CAS=n	1	
veredemus	1	POS=NOMpro|NOMB.=s|GENRE=m|CAS=n	1	
veredemium	2	POS=NOMpro|NOMB.=p|GENRE=m|CAS=n	1	POS=NOMpro|NOMB.=s|GENRE=m|CAS=r	1	
Lemme : flavius	2	1
flavi	1	POS=NOMpro|NOMB.=s|GENRE=m|CAS=r	1	
flavius	1	POS=NOMpro|NOMB.=s|GENRE=m|CAS=n	1	
Lemme : ententif	13	1
ententius	1	POS=ADJqua|NOMB.=s|GENRE=m|CAS=n|DEGRE=p	1	
ententive	2	POS=ADJqua|NOMB.=s|GENRE=f|CAS=n|DEGRE=p	2	
ententivement	4	POS=ADVgen|DEGRE=c	2	POS=ADVgen|DEGRE=-	2	
ententis	6	POS=ADJqua|NOMB.=s|GENRE=m|CAS=n|DEGRE=p	4	POS=ADJqua|NOMB.=p|GENRE=m|CAS=r|DEGRE=p	1	POS=ADJqua|NOMB.=s|GENRE=m|CAS=n|DEGRE=c	1	
Lemme : archemius	1	1
archemius	1	POS=NOMpro|NOMB.=s|GENRE=m|CAS=n	1	
Lemme : lucius	1	1
lucius	1	POS=NOMpro|NOMB.=s|GENRE=m|CAS=n	1	
Lemme : cacavius	1	1
cacavius	1	POS=NOMpro|NOMB.=s|GENRE=m|CAS=n	1	
Lemme : marmorius	1	1
marmorius	1	POS=NOMpro|NOMB.=s|GENRE=m|CAS=r	1	
Lemme : eusebius	1	1
eusebius	1	POS=NOMpro|NOMB.=s|GENRE=m|CAS=n	1	
Lemme : evitius	1	1
evitius	1	POS=NOMpro|NOMB.=s|GENRE=m|CAS=n	1	
Lemme : theralius	1	1
theralius	1	POS=NOMpro|NOMB.=s|GENRE=m|CAS=n	1	
Lemme : cassius	1	1
cassius	1	POS=NOMpro|NOMB.=s|GENRE=m|CAS=n	1	
Lemme : fil2	84	1
fils	1	POS=NOMcom|NOMB.=s|GENRE=m|CAS=n	1	
fuiz	1	POS=NOMcom|NOMB.=p|GENRE=m|CAS=r	1	
fius	1	POS=NOMcom|NOMB.=s|GENRE=m|CAS=n	1	
filz	2	POS=NOMcom|NOMB.=s|GENRE=m|CAS=n	2	
fiuz	27	POS=NOMcom|NOMB.=p|GENRE=m|CAS=r	1	POS=NOMcom|NOMB.=s|GENRE=m|CAS=n	26	
fil	52	POS=NOMcom|NOMB.=p|GENRE=m|CAS=n	3	POS=NOMcom|NOMB.=s|GENRE=m|CAS=r	47	POS=NOMcom|NOMB.=s|GENRE=m|CAS=n	2	
Lemme : anatolius	3	2
anatolius	1	POS=NOMpro|NOMB.=s|GENRE=m|CAS=n	1	
antiolus	1	POS=NOMpro|NOMB.=s|GENRE=m|CAS=n	1	
aurelius	1	POS=NOMpro|NOMB.=s|GENRE=m|CAS=n	1	
Lemme : mieus	17	2
mius	2	POS=ADVgen|DEGRE=c	2	
miuz	2	POS=ADVgen|DEGRE=c	1	POS=ADVgen|DEGRE=-	1	
mielz	13	POS=ADVgen|DEGRE=c	13	
Lemme : evanchius	2	2
evanchius	2	POS=NOMpro|NOMB.=s|GENRE=m|CAS=n	2	
Lemme : mercure	5	2
mercurius	2	POS=NOMpro|NOMB.=s|GENRE=m|CAS=n	2	
mercurie	3	POS=NOMpro|NOMB.=s|GENRE=m|CAS=r	3	
Lemme : eudoxius	2	2
eudoxius	2	POS=NOMpro|NOMB.=s|GENRE=m|CAS=n	2	
Lemme : mathiu	2	2
mathius	2	POS=NOMpro|NOMB.=s|GENRE=m|CAS=n	2	
Lemme : lieu	142	4
lieus	1	POS=NOMcom|NOMB.=p|GENRE=m|CAS=r	1	
lieu	3	POS=NOMcom|NOMB.=s|GENRE=m|CAS=r	2	POS=NOMcom|NOMB.=s|GENRE=m|CAS=r|DEGRE=p	1	
lius	4	POS=NOMcom|NOMB.=s|GENRE=m|CAS=n	1	POS=NOMcom|NOMB.=p|GENRE=m|CAS=r	3	
liu	13	POS=NOMcom|NOMB.=s|GENRE=m|CAS=r	13	
leus	26	POS=NOMcom|NOMB.=p|GENRE=m|CAS=r	17	POS=NOMcom|NOMB.=s|GENRE=m|CAS=n	9	
leu	95	POS=NOMcom|NOMB.=s|GENRE=m|CAS=r	95	
Lemme : arborius	4	4
arborius	4	POS=NOMpro|NOMB.=s|GENRE=m|CAS=r	1	POS=NOMpro|NOMB.=s|GENRE=m|CAS=n	3	
Lemme : ciel	57	4
ciels	1	POS=NOMcom|NOMB.=p|GENRE=m|CAS=r	1	
cius	4	POS=NOMcom|NOMB.=p|GENRE=m|CAS=r	4	
cieus	7	POS=NOMcom|NOMB.=p|GENRE=m|CAS=r	7	
ciel	45	POS=NOMcom|NOMB.=s|GENRE=m|CAS=r	45	
Lemme : voloir	311	4
voldrai	1	POS=VERcjg|MODE=ind|TEMPS=fut|PERS.=1|NOMB.=s	1	
velt	1	POS=VERcjg|MODE=ind|TEMPS=pst|PERS.=3|NOMB.=s	1	
voil	1	POS=VERcjg|MODE=ind|TEMPS=psp|PERS.=1|NOMB.=s	1	
voloirs	1	POS=VERinf|NOMB.=p|GENRE=m|CAS=r	1	
volions	1	POS=VERcjg|MODE=ind|TEMPS=ipf|PERS.=1|NOMB.=p	1	
voellent	1	POS=VERcjg|MODE=sub|TEMPS=pst|PERS.=3|NOMB.=p	1	
vuelent	1	POS=VERcjg|MODE=ind|TEMPS=pst|PERS.=3|NOMB.=p	1	
voudrai	1	POS=VERcjg|MODE=ind|TEMPS=fut|PERS.=1|NOMB.=s	1	
volsist	1	POS=VERcjg|MODE=sub|TEMPS=ipf|PERS.=3|NOMB.=s	1	
voudroiz	1	POS=VERcjg|MODE=ind|TEMPS=fut|PERS.=2|NOMB.=p	1	
vousisses	1	POS=VERcjg|MODE=sub|TEMPS=ipf|PERS.=2|NOMB.=p	1	
voloie	1	POS=VERcjg|MODE=ind|TEMPS=ipf|PERS.=1|NOMB.=s	1	
vourent	1	POS=VERcjg|MODE=ind|TEMPS=psp|PERS.=3|NOMB.=p	1	
veul	1	POS=VERcjg|MODE=ind|TEMPS=pst|PERS.=1|NOMB.=s	1	
vousistes	1	POS=VERcjg|MODE=ind|TEMPS=psp|PERS.=2|NOMB.=p	1	
vousis	1	POS=VERcjg|MODE=ind|TEMPS=psp|PERS.=2|NOMB.=s	1	
veut	2	POS=VERcjg|MODE=ind|TEMPS=pst|PERS.=3|NOMB.=s	2	
voudrions	2	POS=VERcjg|MODE=con|PERS.=1|NOMB.=p	2	
vousissent	2	POS=VERcjg|MODE=sub|TEMPS=ipf|PERS.=3|NOMB.=p	2	
voeil	3	POS=VERcjg|MODE=ind|TEMPS=pst|PERS.=1|NOMB.=s	2	POS=VERcjg|MODE=ind|TEMPS=pst|PERS.=3|NOMB.=s	1	
voloir	3	POS=NOMcom|NOMB.=s|GENRE=m|CAS=r	1	POS=VERinf|NOMB.=s|GENRE=m|CAS=r	2	
voudra	3	POS=VERcjg|MODE=ind|TEMPS=fut|PERS.=3|NOMB.=s	3	
volons	4	POS=VERcjg|MODE=ind|TEMPS=pst|PERS.=1|NOMB.=p	4	
voloies	4	POS=VERcjg|MODE=ind|TEMPS=ipf|PERS.=2|NOMB.=s	4	
voudroie	4	POS=VERcjg|MODE=con|PERS.=1|NOMB.=s	4	
viut	4	POS=VERcjg|MODE=ind|TEMPS=pst|PERS.=3|NOMB.=s	4	
vius	4	POS=VERcjg|MODE=ind|TEMPS=pst|PERS.=2|NOMB.=s	4	
veus	4	POS=VERcjg|MODE=ind|TEMPS=pst|PERS.=2|NOMB.=s	4	
voelle	5	POS=VERcjg|MODE=sub|TEMPS=pst|PERS.=3|NOMB.=s	5	
volt	6	POS=VERcjg|MODE=ind|TEMPS=psp|PERS.=3|NOMB.=s	6	
voelent	7	POS=VERcjg|MODE=ind|TEMPS=pst|PERS.=3|NOMB.=p	7	
voudroit	7	POS=VERcjg|MODE=con|PERS.=3|NOMB.=s	6	POS=VERcjg|MODE=cond|PERS.=3|NOMB.=s	1	
voudrent	7	POS=VERcjg|MODE=ind|TEMPS=psp|PERS.=3|NOMB.=p	7	
volez	9	POS=VERcjg|MODE=ind|TEMPS=pst|PERS.=2|NOMB.=p	9	
vousist	15	POS=VERcjg|MODE=sub|TEMPS=ipf|PERS.=3|NOMB.=s	15	
voloient	21	POS=VERcjg|MODE=ind|TEMPS=ipf|PERS.=3|NOMB.=p	21	
voel	22	POS=VERcjg|MODE=ind|TEMPS=pst|PERS.=1|NOMB.=s	21	POS=VERcjg|MODE=ind|TEMPS=pst|PERS.=3|NOMB.=s	1	
vout	60	POS=VERcjg|MODE=ind|TEMPS=psp|PERS.=3|NOMB.=s	60	
voloit	97	POS=VERcjg|MODE=ind|TEMPS=ipf|PERS.=3|NOMB.=s	97	
Lemme : refrigerius	6	6
refrigerius	6	POS=NOMpro|NOMB.=s|GENRE=m|CAS=n	6	
Lemme : piu	16	12
piue	1	POS=ADJqua|NOMB.=s|GENRE=f|CAS=r|DEGRE=p	1	
piu	3	POS=ADJqua|NOMB.=p|GENRE=m|CAS=n|DEGRE=p	3	
pius	12	POS=ADJqua|NOMB.=s|GENRE=m|CAS=n|DEGRE=p	9	POS=ADJqua|NOMB.=s|GENRE=m|CAS=n|DEGRE=s	3	

