a libre tonique  > ei §1
Mot	Nombres d'occurrences total	Nombre d'occurrences
Lemme : encore	131	1
eincore	1	DEGRE=-	1	
encor	2	DEGRE=-	2	
encores	2	DEGRE=-	2	
encore	126	DEGRE=-	126	
Lemme : orgoillos	4	1
orgueilleus	1	NOMB.=s|GENRE=m|CAS=r|DEGRE=p	1	
orguilleus	3	NOMB.=s|GENRE=m|CAS=r|DEGRE=p	2	NOMB.=s|GENRE=m|CAS=n|DEGRE=p	1	
Lemme : plegement	1	1
pleignement	1	NOMB.=p|GENRE=m|CAS=n	1	
Lemme : mortagne	3	1
morteigne	1	NOMB.=s|GENRE=f|CAS=n	1	
mortaigne	2	NOMB.=s|GENRE=m|CAS=r	1	NOMB.=s|GENRE=f|CAS=r	1	
Lemme : foie2	77	1
foies	1	NOMB.=p|GENRE=f|CAS=r	1	
feiz	1	NOMB.=p|GENRE=m|CAS=r	1	
fois	1	NOMB.=s|GENRE=f|CAS=r	1	
foïe	2	NOMB.=s|GENRE=f|CAS=r	2	
foie	6	NOMB.=s|GENRE=f|CAS=r	6	
foiz	66	NOMB.=p|GENRE=f|CAS=r	31	NOMB.=s|GENRE=f|CAS=r	34	NOMB.=s|GENRE=f|CAS=n	1	
Lemme : volille	1	1
voleilles	1	NOMB.=p|GENRE=f|CAS=r	1	
Lemme : covenable	5	1
covegnables	1	NOMB.=s|GENRE=m|CAS=n|DEGRE=p	1	
covenable	1	NOMB.=s|GENRE=m|CAS=r|DEGRE=p	1	
couveignable	1	NOMB.=s|GENRE=m|CAS=r|DEGRE=p	1	
covignable	2	NOMB.=s|GENRE=m|CAS=r|DEGRE=p	1	NOMB.=s|GENRE=m|CAS=n|DEGRE=s	1	
Lemme : cler	16	1
cleirs	1	NOMB.=s|GENRE=m|CAS=n|DEGRE=s	1	
cler	3	NOMB.=s|GENRE=f|CAS=r|DEGRE=p	1	NOMB.=s|GENRE=m|CAS=n|DEGRE=p	1	NOMB.=s|GENRE=m|CAS=r|DEGRE=c	1	
clers	5	NOMB.=p|GENRE=m|CAS=r	3	NOMB.=s|GENRE=m|CAS=n|DEGRE=c	1	NOMB.=s|GENRE=m|CAS=n|DEGRE=p	1	
clere	7	NOMB.=s|GENRE=f|CAS=r|DEGRE=c	1	NOMB.=s|GENRE=f|CAS=n|DEGRE=p	2	NOMB.=s|GENRE=f|CAS=r|DEGRE=p	2	NOMB.=s|GENRE=f|CAS=n|DEGRE=s	1	NOMB.=s|GENRE=f|CAS=r|DEGRE=s	1	
Lemme : lé	4	1
lees	1	NOMB.=p|GENRE=f|CAS=r|DEGRE=p	1	
leiz	1	NOMB.=s|GENRE=m|CAS=n|DEGRE=p	1	
lee	2	NOMB.=s|GENRE=f|CAS=n|DEGRE=p	1	NOMB.=s|GENRE=f|CAS=n|DEGRE=s	1	
Lemme : moinsné	1	1
meinsnez	1	NOMB.=p|GENRE=m|CAS=n	1	
Lemme : athenes	2	2
atheines	2	NOMB.=s|GENRE=f|CAS=r	2	
Lemme : charlemagne	2	2
charlemeine	2	NOMB.=s|GENRE=m|CAS=r	2	
Lemme : consule	17	2
conselle	1	NOMB.=s|GENRE=m|CAS=r	1	
concele	2	NOMB.=s|GENRE=m|CAS=r	1	NOMB.=s|GENRE=m|CAS=n	1	
conseile	2	NOMB.=s|GENRE=m|CAS=r	2	
consele	3	NOMB.=s|GENRE=m|CAS=r	3	
conseles	4	NOMB.=s|GENRE=m|CAS=n	4	
conceles	5	NOMB.=s|GENRE=m|CAS=n	4	NOMB.=p|GENRE=m|CAS=n	1	
Lemme : tel	177	3
atieus	1	NOMB.=s|GENRE=m|CAS=r	1	
tieuz	1	NOMB.=s|GENRE=m|CAS=n|DEGRE=p	1	
tiels	1	NOMB.=p|GENRE=f|CAS=r	1	
teus	1	NOMB.=p|GENRE=f|CAS=r	1	
teil	3	NOMB.=s|GENRE=f|CAS=n	1	NOMB.=s|GENRE=m|CAS=r	1	NOMB.=s|GENRE=f|CAS=r	1	
teles	7	NOMB.=p|GENRE=f|CAS=r	7	
tieus	28	NOMB.=p|GENRE=m|CAS=r	6	NOMB.=s|GENRE=f|CAS=n	1	NOMB.=p|GENRE=f|CAS=r	16	NOMB.=s|GENRE=m|CAS=n	3	NOMB.=p|GENRE=f|CAS=n	1	NOMB.=p|GENRE=m|CAS=n	1	
tele	32	NOMB.=s|GENRE=f|CAS=r	27	NOMB.=s|GENRE=f|CAS=n	5	
tel	103	NOMB.=s|GENRE=f|CAS=r	86	NOMB.=s|GENRE=m|CAS=r	17	
Lemme : regne	24	3
regnes	2	NOMB.=s|GENRE=m|CAS=n	2	
reigne	3	NOMB.=s|GENRE=m|CAS=r	3	
regne	19	NOMB.=s|GENRE=m|CAS=r	19	
Lemme : nëis	4	4
neis	4	DEGRE=-	2	
Lemme : none1	6	4
nonains	2	NOMB.=p|GENRE=f|CAS=r	1	NOMB.=p|GENRE=f|CAS=n	1	
noneins	4	NOMB.=p|GENRE=f|CAS=r	3	NOMB.=p|GENRE=f|CAS=n	1	
Lemme : compagnon	61	8
conpaignons	1	NOMB.=p|GENRE=m|CAS=r	1	
compagnons	1	NOMB.=p|GENRE=m|CAS=r	1	
compains	2	NOMB.=s|GENRE=m|CAS=n	2	
compeinz	3	NOMB.=s|GENRE=m|CAS=n	3	
compeins	5	NOMB.=p|GENRE=m|CAS=n	1	NOMB.=s|GENRE=m|CAS=n	4	
compaignons	23	NOMB.=p|GENRE=m|CAS=r	22	NOMB.=p|GENRE=m|CAS=n	1	
compaignon	26	NOMB.=p|GENRE=m|CAS=n	6	NOMB.=s|GENRE=m|CAS=r	18	NOMB.=s|GENRE=m|CAS=r|DEGRE=p	1	NOMB.=p|GENRE=m|CAS=r	1	
Lemme : moins	10	9
mendres	1	NOMB.=s|GENRE=m|CAS=n|DEGRE=s	1	
meinz	2	DEGRE=-	1	DEGRE=c	1	
meins	7	DEGRE=c	4	NOMB.=s|GENRE=m|CAS=r	1	DEGRE=s	1	DEGRE=-	1	


avu  > au, eu, oi - essai sur poi §2

Mot	Nombres d'occurrences total	Nombre d'occurrences
Lemme : chandoile	2	1
chaudele	1	NOMB.=s|GENRE=f|CAS=r	1	
chandele	1	NOMB.=s|GENRE=f|CAS=r	1	
Lemme : roiaume	1	1
roiaume	1	NOMB.=s|GENRE=m|CAS=r	1	
Lemme : poissonel	1	1
pissonniaus	1	NOMB.=p|GENRE=m|CAS=r	1	
Lemme : enoios	1	1
annieuse	1	NOMB.=s|GENRE=f|CAS=n|DEGRE=p	1	
Lemme : covoitos	1	1
covoiteus	1	NOMB.=s|GENRE=m|CAS=n|DEGRE=p	1	
Lemme : roial2	7	1
roiaus	1	NOMB.=p|GENRE=f|CAS=r|DEGRE=p	1	
roial	6	NOMB.=s|GENRE=f|CAS=r|DEGRE=p	2	NOMB.=s|GENRE=m|CAS=r|DEGRE=p	4	
Lemme : orgoillosement	1	1
orguelleusement	1	DEGRE=s	1	
Lemme : angoissos	2	2
angoisseus	2	NOMB.=s|GENRE=m|CAS=n|DEGRE=p	1	NOMB.=s|GENRE=m|CAS=n|DEGRE=s	1	
Lemme : oisos	2	2
oiseuses	1	NOMB.=p|GENRE=f|CAS=r|DEGRE=p	1	
oiseuse	1	NOMB.=s|GENRE=f|CAS=r|DEGRE=p	1	
Lemme : poi	50	3
peu	3	NOMB.=s|GENRE=m|CAS=r	2	DEGRE=s	1	
poi	8	NOMB.=s|GENRE=m|CAS=r	5	NOMB.=s|GENRE=n|CAS=r	1	DEGRE=-	1	NOMB.=s|GENRE=n|CAS=n	1	
pou	39	DEGRE=-	16	NOMB.=s|GENRE=n|CAS=r	12	NOMB.=s|GENRE=m|CAS=r	9	NOMB.=s|GENRE=m|CAS=n	2	
Lemme : voisos	3	3
viseus	1	NOMB.=s|GENRE=m|CAS=n|DEGRE=p	1	
voiseus	2	NOMB.=p|GENRE=m|CAS=n|DEGRE=p	1	NOMB.=s|GENRE=m|CAS=n|DEGRE=p	1	
Lemme : orgoillos	4	4
orgueilleus	1	NOMB.=s|GENRE=m|CAS=r|DEGRE=p	1	
orguilleus	3	NOMB.=s|GENRE=m|CAS=r|DEGRE=p	2	NOMB.=s|GENRE=m|CAS=n|DEGRE=p	1	
Lemme : joios	5	5
joïeus	1	NOMB.=s|GENRE=m|CAS=n|DEGRE=p	1	
joieuse	2	NOMB.=s|GENRE=f|CAS=n|DEGRE=p	1	NOMB.=s|GENRE=f|CAS=n|DEGRE=s	1	
joieus	2	NOMB.=s|GENRE=m|CAS=n|DEGRE=p	2	
Lemme : oisel	9	7
oisel	2	NOMB.=p|GENRE=m|CAS=n	2	
oiseaus	7	NOMB.=p|GENRE=m|CAS=r	4	NOMB.=s|GENRE=m|CAS=n	3	
Lemme : chamoil	12	7
chamel	5	NOMB.=s|GENRE=m|CAS=r	1	NOMB.=p|GENRE=m|CAS=n	4	
chameus	7	NOMB.=p|GENRE=m|CAS=r	4	NOMB.=p|GENRE=m|CAS=n	3	
Lemme : besoignos	11	11
besoigneuz	2	NOMB.=s|GENRE=m|CAS=r|DEGRE=p	1	NOMB.=s|GENRE=m|CAS=n|DEGRE=p	1	
besoigneus	9	NOMB.=p|GENRE=m|CAS=r	5	NOMB.=p|GENRE=m|CAS=n|DEGRE=p	2	NOMB.=s|GENRE=m|CAS=n|DEGRE=p	1	NOMB.=s|GENRE=m|CAS=r|DEGRE=p	1	

Graphie du mot poi

lemme : poi	Nombres d'occurrences : 50
peu	3	NOMB.=s|GENRE=m|CAS=r	2	DEGRE=s	1	
poi	8	NOMB.=s|GENRE=m|CAS=r	5	NOMB.=s|GENRE=n|CAS=r	1	DEGRE=-	1	NOMB.=s|GENRE=n|CAS=n	1	
pou	39	DEGRE=-	16	NOMB.=s|GENRE=n|CAS=r	12	NOMB.=s|GENRE=m|CAS=r	9	NOMB.=s|GENRE=m|CAS=n	2	

Alternance ar/er suivi de consonne

Mot	Nombre total	Nombre d'occurrences en condition 1	Nombre d'occurrences condition 2

Lemme : larme	4	1	3
larmes	1	NOMB.=p|GENRE=f|CAS=r	1	
lermes	3	NOMB.=p|GENRE=f|CAS=r	3	

Lemme : parlier	1	1	1
parliers	1	NOMB.=s|GENRE=m|CAS=n	1	

Lemme : archier	2	2	1
archier	1	NOMB.=s|GENRE=m|CAS=n	1	
archiers	1	NOMB.=p|GENRE=m|CAS=r	1	

Lemme : armenie	3	2	1
hermenie	1	NOMB.=s|GENRE=f|CAS=r	1	
armenee	1	NOMB.=s|GENRE=f|CAS=r	1	
armenie	1	NOMB.=s|GENRE=f|CAS=r	1	

Lemme : parçonier	4	3	2
parçonier	2	NOMB.=x|GENRE=x|CAS=x	1	NOMB.=p|GENRE=m|CAS=n	1	
parçoniers	2	NOMB.=s|GENRE=m|CAS=n|DEGRE=p	1	NOMB.=s|GENRE=m|CAS=n	1	

Lemme : larron	9	6	2
leres	1	NOMB.=s|GENRE=m|CAS=n	1	
lerres	2	NOMB.=s|GENRE=m|CAS=n	1	NOMB.=p|GENRE=m|CAS=r	1	
larrons	2	NOMB.=p|GENRE=m|CAS=n	2	
larron	4	NOMB.=p|GENRE=m|CAS=n	3	NOMB.=s|GENRE=m|CAS=r	1	


talis, qualis §5
Graphie du mot tel

lemme : 	Nombres d'occurrences : 0


Graphie du mot qel

lemme : 	Nombres d'occurrences : 0

ATICU > age/aige/ege $7
Mot	Nombre total	Nombre d'occurrences en condition 1	Nombre d'occurrences condition 2


yod + ATA $8
PPF des verbes du 1er groupe en ier avec auxiliaire être :  Nb total d'occurrence	0
Participe en -ie(s) : Nb total d'occurrence	36
Terme	Nombre d'occurrences	Occurrences du texte
trenchier1	1	trenchie
aidier	1	aidie
esmaiier	1	esmaie
apaisier	4	apesies, apeisie, apesie
amenuisier	4	amenuisie
negier	2	negie
aprochier	2	aprochie
moillier1	1	mollie
baillier	1	baillie
noncier1	1	noncie
couchier	1	acouchie
essaucier	2	essaucie
travaillier	2	traveillie
batisier	2	baptizie, baptiziez
apareillier1	2	appareillies, apareillie
abaissier	2	abessie
conchiier	1	conchies
desconseillier	1	desconseillies
chargier	1	charchies
brisier	1	brisie
sechier	1	sechie
eslëecier	1	esleecies
atachier2	1	atachie

Participe en -iee(s) : Nb total d'occurrence	3
Terme	Nombre d'occurrences	Occurrences du texte
sechier	1	sechiee
escomeniier	2	escomeniee, escomenieez

Autres formes : Nb total d'occurrence	2
Terme	Nombre d'occurrences	Occurrences du texte
descirier	1	desciree
otroiier	1	otroïe

