Nb de leçons divergente entre l'édition et témoin :1623
Nb de leçons en commun avec G1 :552
Nb de lieux variants en commun avec G1 :926
Nb de leçons en commun avec M1 :1623
Nb de lieux variants en commun avec M1 :1623

Nb de leçons en commun avec N :1021
Nb de lieux variants en commun avec N :1263

ajout
125
Pourcentage : 7.701786814540973
Nb de leçons en commun avec G1 :38
Nb de lieux variants en commun avec G1 :93

Nb de leçons en commun avec M1 :125
Nb de lieux variants en commun avec M1 :125

Nb de leçons en commun avec N :60
Nb de lieux variants en commun avec N :107

Lemme 	leçon
si	et si (G1 M1 N)	4
Et	Et quant (G1 M1)	2
le grant chemin plenier	le grant chemin plenier et la grant voie
                batue (G1 M1 N)	1
et sa mere	malgré se mere (M1)	1
baptiziés	crestiens ne baptisiés (M1)	1
les nuz	les nus cui povretés et besoigne destraignoit (M1)	1
donoit tout as povres	donnoit por Dieu as povres (M1)	1
qe son mantel	ne autre creature qu'il li peüst doner que son
                mantel (M1)	1
dit	dit qu'il iroit tout desarmés contre ses anemis, si conme
                il l'avoit mis en couvenanche (M1)	1
encore	qui est cil qui doute que (M1 N)	1
soit plus nostre Sires puissanztouz puissanz	nostre Sires ne soit pius et misericors et
                poissans (M1 N)	1
proia	proia il (C3 G1 M1)	1
plus	plus ore (M1)	1
a vraie creance	a vraie foi et a veraie creance (G1 M1 N)	1
droite voie	a droit chemin et se droite voie (M1)	1
molt	puis molt (G1 M1 N)	1
meintenant	tantost qu'il ot ce dit (M1)	1
granz loenges	molt grans loenges (G1 M1 N)	1
grant	puis grant (M1)	1
ausint	assamblé en rendirent graces a nostre Segneur (M1 N)	1
chasteaus	prochains castiaus (M1 N)	1
qi	et quex eglise qui (M1)	1
example prendre	prendre essample de bien (G1 M1)	1
autres	as autres (M1 N)	1
la glorieuse vie	le glorieuse vie es chiex (M1 N)	1
alumee	alumee et arse (G1 M1 N)	1
enfoïz	desous ensevelis et enfoïs (M1)	1
martyrs	beneois martyrs (M1)	1
les genz	le pueple et ses genz (M1)	1
se porpensoient	se porpensoient et merveilloient (M1)	1
genz	genz sarrazines (G1 M1 N)	1
Sires	Sires que tu aoures (G1 M1)	1
et a ceste covenence se tindrent bien	et qu'il se tenoient bien ce disent a ceste
                convenenche (M1)	1
Li moigne qi estoient deciple	il estoit molt grans a desmesure et molt estoit haut.
                Li moine qui estoient deciple (M1 N)	1
ploroient	prisent a plorer (M1 N)	1
establissoit il et faisoit	establissoit il autel de crestiens et faisoit (M1)	1
car	car bien saichiés qu' (M1 N)	1
ravaler	a devaler a tout le coup (M1 N)	1
manoient	manoient et habitoient (G1 M1 N)	1
granz vertuz	grans vertus por bien ne por diginité qu'en lui eüst (M1)	1
de	del pere a (M1)	1
tormentoit	tormentoit molt (M1)	1
molt dolereusement	de molt dolereuse painne (M1 N)	1
i ala por lui amener	i ala por le dervé amener au saint home (M1 N)	1
foi	sainte foi (M1 N)	1
fist	fist maintenant (M1)	1
et entra en un serjant de la meson	et encontra un sergent de la maison, si li entra el
                cors (G1 M1 N)	1
meüst	meüst en nule maniere (G1 M1 N)	1
chaut	tout chaut (G1 M1 N)	1
durer	durer en nule maniere (G1 M1 N)	1
des oevres au deable	del deable par les oevres saint Martin (M1 N)	1
des messagiers	de messaiges par le contree errans (M1 N)	1
cez messages	ches messaiges et ces nouveles (M1 N)	1
dist	li dist (M1)	1
toz	touz celz qui la estoient (G1 M1 N)	1
trova	trouva la (M1)	1
por retenir et oïr	por oïr et retenir (M1)	1
seint Martin	monseigneur saint Martin (M1)	1
puis	puis chel jour (M1)	1
couchierent	coucherent en son habitacle (M1)	1
evesqes	pluseurs evesques (G1 M1 N)	1
comandast	li conmandast (G1 M1 N)	1
proia li empereres	proia Maximes li empereres (M1)	1
lor guerissons	leur garisons et leur regnes (G1 M1 N)	1
l'empereor	Maxime l'empereor (M1)	1
Li empereres si fu molt liez	molt fu liés Maximes li empereres de grant maniere (M1)	1
autres	autres mes aprés (M1)	1
de cui tous li  biens vientli biens toz viennent en terre et el ciel lassus	car de lui vient trestoz li biens qi sont el siecle
                terrien et trestous chilx el chiel lassus (M1 N)	1
trestoz	tant com il mengerent et tout cil qui
                    servoient (M1 N)	1
rasamblees	assemblees et requises (G1 M1 N)	1
trestorner ne partir	quatir ne destorner a nul fuer (M1)	1
Si	Et si (G1 M1)	1
toute sanglante	toute sanglente. Dont moustra au saint home sa main
                et son braz tout sanglent (G1 M1 N)	1
moroit	moroit et qu'il ne rendoit l'ame (G1 M1 N)	1
Il escoust	Il escoust, fait il, (G1 M1)	1
devant eus toz	devant les sains homes qui la estoient assamblé (M1)	1
la croiz	le sainte crois (M1 N)	1
n'en avoit ne poor	n'avoit del deale ne paor (M1 N)	1
ooientoïrent soventes foiz	ooient soventes fois et entendoient (M1)	1
qi les	qi les pechiés (M1)	1
mie avoir pardon	avoir pardon de nostre Segneur ne nule indulgence (M1)	1
apela un de ses freres	parla a lui un des ses freres, mais Natholius l'apela
                ançois (M1)	1
la vesteüre	le vesteüre qe cil avoit vestue (M1)	1
pluisors afaires	pluisors signes a faire (M1)	1
vraiement	cose sans doutance (M1 N)	1
cez choses avez oïes	avés oïes et entendues ces coses (M1 N)	1
a veritables	a veritables ne mie a menchoignes ne a fables (M1 N)	1
le seint home	le saint home lonc tans (M1)	1
pechiés	pekiés et felonie (M1)	1
ne n'avoit autres coutes	seur che avoit apris a gesir li sains evesques ne
                autres kieutes (M1 N)	1
n'autres orelliers ne autres lincieus	ne autres linchex ne autres oreilhers n'avoit li sains
                hom (M1 N)	1
flamber	faire grant flambe (G1 M1 N)	1
entendi tant	tendi tant se main et entendi (M1)	1
grant	si grant (G1 M1 N)	1
se coucha	s'estendi adens (M1)	1
la flambe ne li feus	les flanmes ne les caurres qi grandes estoient et
                desmesurees (M1)	1
qant	et qant (C2 C3 G1 M1 N)	1
Lors	Et qant il oïrent chou, si (M1 N)	1
desfendera	les desfendera (G1 M1)	1
li pasteur n'i sera mie	li paistres ne les desfendera mie ne nos sera (M1)	1
meüs en pitié	meüs par le duel que si desciples faisoient (M1)	1
volentiers deguerpir	volentiers departir ne iaus deguerpir (M1)	1
nuisance	nuisance ne grever (M1 N)	1
Car il estoit plus blans qe leiz ne noiz negie	Il estoit plus purs et plus blans que lais ne que noif
                negie (M1 N)	1
et as voies	et en voies et en chemins (M1 N)	1
une grant tençon	une grant tence et une grans discorde (M1)	1
ce	che fait (M1 N)	1
il en tel maniere	li un et li autre en tel maniere et estriverent (M1)	1
sachiez bien	sache bien qi ce demande (M1 N)	1
bien convertie a la crestiene loy	bien a le crestienne loi convertie (M1)	1
conté	devant conté (M1)	1
si entendist	si mesist en l'escouter toute s'entente (M1)	1
chose nule	a cele fois nule cose (M1)	1
el ciel	qu'il l'enportent lasus el ciel (G1 M1 N)	1
lor compaignie	se crueuse compagnie (M1)	1
com seint Martin	et aorné de si bones oevres conme sires sains Martins
                estoit (M1)	1
l'ame	l'ame du saint home (G1 M1 N)	1
de	de la cité de (G1 M1 N)	1
seinz Ambroses	li sains hom sains Ambroises (M1 N)	1
valu	valu et conforté (G1 M1)	1
car	Et bien sachiez que (G1 M1 N)	1

casAbs
4
Pourcentage : 0.24645717806531117
Nb de leçons en commun avec G1 :1
Nb de lieux variants en commun avec G1 :2

Nb de leçons en commun avec M1 :4
Nb de lieux variants en commun avec M1 :4

Nb de leçons en commun avec N :2
Nb de lieux variants en commun avec N :2

Lemme 	leçon
del	le (M1)	1
nostre Signor	de nostre Seignor (C2 C3 M1)	1

etym.
17
Pourcentage : 1.0474430067775724
Nb de leçons en commun avec G1 :9
Nb de lieux variants en commun avec G1 :10

Nb de leçons en commun avec M1 :17
Nb de lieux variants en commun avec M1 :17

Nb de leçons en commun avec N :13
Nb de lieux variants en commun avec N :15

Lemme 	leçon
erent	estoient (M1 N)	6
ert	estoit (M1 N)	6
estoit	iert (M1)	2
n'ert	n'estoit (M1 N)	1
n'estoient	n'ierent (M1 N)	1
erent receü	estoient cheü (M1)	1

inv.
130
Pourcentage : 8.009858287122611
Nb de leçons en commun avec G1 :41
Nb de lieux variants en commun avec G1 :69

Nb de leçons en commun avec M1 :130
Nb de lieux variants en commun avec M1 :130

Nb de leçons en commun avec N :72
Nb de lieux variants en commun avec N :95

Lemme 	leçon
petit avoir fait	avoir petit fait (G1 M1)	1
YsabbarieYsapharie avoit nonestoit apelez	qui avoit a non Ysapharie (M1)	1
et de par mere et de par pere	et de par pere et de par mere (G1 M1 N)	1
qi le servoit tant seulement	tant seulement qui le servoit (M1 N)	1
c'on en lui veoit	que on veoit en lui (M1 N)	1
et norrissoit les besoigneus	et les besoigneus norrissoit (M1)	1
as povres et departies	et departies as povres (M1)	1
vestuz estoit	estoit vestuz (G1 M1 N)	1
a douner et a departir	a departir et a donner (C2 C3 G1 M1)	1
nostre Signeur Deu	Dieu nostre Seigneur (M1)	1
estoit a venir a lendemein	lendemain estoit a venir (M1 N)	1
Li empereres, qant il oï ce, 	qant ce oï li emperieres (G1 M1 N)	1
trova bien et prova	prova bien et trova (M1 N)	1
hauça li uns	li uns hauça (G1 M1 N)	1
a l'un d'eus a garder et a tenir	a garder a l'un d'iaus et a tenir (M1)	1
molt li pria	li pria molt (M1 N)	1
eü mout longement	molt longement eü (M1)	1
le laidengierent et batirentle batirent de verges	le batirent il de verges et le laidengierent (M1)	1
de la seinz Martins  departiz	sainz Martins partis de la (M1 N)	1
fu mout dolenz, si conmença a plo--rer	conmença a plorer et fu molt dolanz (G1 M1 N)	1
Adonc et en cel tens	En chel tans adont (M1)	1
a la cité venist	venist a la chité (M1)	1
ordenez a evesqe en la cité de Tors li seinz hom	ordenés li sains hom a evesque en le cité de Tours (M1)	1
devant avoit	avoit devant (G1 M1 N)	1
cheve estoit	estoit cavee (G1 M1 N)	1
estoient en communité mises totes lor choses	toutes leur choses estoient mises en communité (G1 M1)	1
s'enfermetez ne le destreignoits'il n'avoit enfermeté ou trop granz maladieaucune maladie	s'enfermetés ou trop grant maladie ne le
                destraingnoit (M1)	1
poesté ont	ont poesté (M1)	1
fet fere un autel	fet un autel fere (C3 M1 N)	1
par grant amor et par  grant diligense	par grant diligence et par grant amor (M1 N)	1
en l'oneur de celui	a celui honour (M1 N)	1
de loing qi venoit	qui de loing venoit (M1)	1
les covroient de blans dras, si les comportoientportoient	les couvroient de blanc dras et les portoient (M1)	1
ancien temple	temple ancien (G1 M1 N)	1
adonqes en cel tens	a cel tans adonc (G1 M1)	1
le temple despecié	depechié le temple (M1 N)	1
et droit et lonc	et lonc et droit (M1 N)	1
sacré et beneï	beneï et sacré (G1 M1 N)	1
celui einsi	ainssi celui (G1 M1)	1
d'eus avoir	avoir d'iaus (M1)	1
ensus traite	traite ensus (M1)	1
de cheïr fere samblant	a faire semblant de chaoir (G1 M1 N)	1
a venir envers  lui et a cheïr	a caïr vers lui et a venir (M1)	1
i estoient soventes foiz joïessouvent veües et celebrees	soventes fois i estoient joïes celebrees (M1 N)	1
li venz comença	conmencha li vens (M1 N)	1
Une autre foiz avint	Lors avint une autre fois (M1 N)	1
en orissons et en jeunesjuner	en jeunes et en orissons (M1)	1
avoitl'avoit entrepris a fere	entreprise l'avoit a faire (M1)	1
creoit et aoroit	aouroit et creoit (G1 M1 N)	1
totes genz doivent	devoient toutes gens (M1 N)	1
un temple depecier	depechier un temple (M1)	1
contremontamont l'espee	l'espee contremont (M1 N)	1
arrierea terre toz estenduz	touz estenduz arriere (G1 M1 N)	1
a celui qe j'ai
                conté dessamblables	dessamlables a celui que j'ai conté (M1)	1
ot le colp entesé	ot entesé le cop (M1 N)	1
et dist soudeinement	molt soudainement et dist (G1 M1)	1
en la cité venuz	venuz en la cité (G1 M1 N)	1
au seint home por reqerrepor le reqerre	pour requerre au saint home (G1 M1 N)	1
ja seinz Martins	sains Martins ja (M1)	1
a nostre Signor et sa proiereses proieres	et ses prieres a nostre Seigneur (M1)	1
entrez el cors	el cors entrés (M1 N)	1
meïst sa mein qi dervez estoit	qui estoit desvez meïst sa main (G1 M1)	1
puissance de lui traveillier	de lui travaillier puissance (G1 M1 N)	1
molt dolant et mout tristre	molt tristre et dolant (M1)	1
devorer et ocirre as denz	as denz devorer et ochirre (M1 N)	1
arriere mout tost	molt tost arriere (G1 M1 N)	1
venir sor eus	seur euls venir (G1 M1)	1
devant lui venir	venir devant lui (M1 N)	1
portoient tieus noveles	tex nouveles portoient (M1)	1
delivree de l'enemidel deable	del deale delivree (M1)	1
un pou de ses vesteüres avoient	avoient un peu de ses vesteüres (M1 N)	1
parpour ce qu'il a eus les atouçoient	por che qu'il les atouchoient a iax (M1)	1
ceste vie entendent	entendent ceste vie (G1 M1 N)	1
la lumiere receüe	recheüe le lumiere (M1 N)	1
montés en un cenaillchevalsolier par une eschiele	par une eschiele montés seur un cenaile (M1 N)	1
santé receüe lendemein	lendemain santé recheüe (M1 N)	1
en sa compaignie estoit venuz	estoit venuz en sa compaignie (G1 M1)	1
devant l'empereor tenoit la coupe d'or	la coupe d'or tenoit devant l'empereor (G1 M1 N)	1
agenoilliez estoit	estoit agenoilliés (M1)	1
la coupe baillié au prestre	au prestre la coupe baillie (G1 M1)	1
devoient avenir	avenir devoient (G1 M1 N)	1
demostrer et fere	faire et demoustrer (G1 M1 N)	1
le deable einsi parler	ainsi parler le deable (G1 M1 N)	1
bien poez	si poés bien (M1 N)	1
conté et dit	et dit et conté (M1)	1
tous cels de lor pechiés	de leurs pechiés tous chiaus (M1 N)	1
a lui parloit	parloit a lui (M1)	1
lor cuers et lor ententes	leur ententes et leur cuers (G1 M1 N)	1
veoir la	le veïr (M1 N)	1
fu ele	ele fu (C2 G1 M1)	1
a pluisors croireacroire	croire as plusors (M1)	1
li evesqes puis	puis li evesques (G1 M1)	1
a temptertempester seint Martin en celce  tempoiretans	saint Martin en cel tempoire a tempter (M1)	1
en orissons toz seus	tous seus en orisons (M1 N)	1
precieuses pierres	pierres precieuses (G1 M1 N)	1
ceste parole autre foiz a dire	autre fois a parler ceste parole (M1)	1
dire au seint home de sa bouche	le saint home de sa bouche conter et dire (M1 N)	1
cuidié et dit	dit et cuidié (G1 M1 N)	1
proprementpremierement le vit	le vit proprement (C2 M1)	1
a peines ose	oz a paine (G1 M1 N)	1
avoir lui meïsmes garanti	avoir garandit lui meïsmes (M1 N)	1
fesoit molt grant froidure	molt faisoit grant froidure (M1 N)	1
il n'ot	n'ot il (M1 N)	1
mal feire	faire mal (M1 N)	1
peine: autre	autre painne (M1)	1
c'estce estc'estoit uns chastiaus entre Poitou et ToraineTours, se descordoientqui ainssi les desheritoient	se descordoient, cil Condeit estoit uns castiaus entre
                Poitou et Toraine (M1)	1
par sa seinte parolesaint Martin par saintes paroles et puissanz as oiseausceuls	as oisiaus par se sainte parole (M1)	1
q'ilqui arrester n'i oserent: por la parole del seint home	par le parole del saint home qe arrester n'i oserent (M1)	1
aler devoit	devoit aler (G1 M1 N)	1
remisemis la pes	le pais remise (M1 N)	1
arriere en son leu	a son lieu arriere (M1 N)	1
toutes les forces de ses membres li conmencierent a faillirdeffaillir	li conmencherent a defaillir totes les forces de ses
                membres (M1 N)	1
grant duel a demener	a demener grant duel (M1)	1
de doçor et de repoz	de repos et de douceur (G1 M1)	1
einçois esgarder le ciel	esgarder le chiel anchois (M1)	1
tot aussiensement	aussi tout (M1 N)	1
plenierement devant	devant plenierement (M1 N)	1
nos a fetes	a nous faites (M1 N)	1
n'a fait aavec nos	n'en ait avec nous fait (M1 N)	1
certeinecerte chose	cose certaine (M1)	1
poissanz est	est puissanz (G1 M1)	1
feïssent assez	assés li feïssent (M1 N)	1
por oïr et por entendre	por entendre et pour oïr (M1 N)	1
a terre ambedui	ambedui a terre (G1 M1)	1
el ciel demenoient	demenoient el chiel (M1 N)	1
le peüssent arrester ne tant ne qant	ne tant ne qant arrester le peüssent (M1 N)	1
de seint Ambrose le boneüré evesqe	del evesque le boneüré saint Ambroise (M1)	1
epistre ne leçon	lechon ne epistre (M1 N)	1
celestieus vertuz	vertus celestieus (M1 N)	1
i demeinentmainent grant joie et leesche	joie et leeche i demainent (M1)	1

plur.
13
Pourcentage : 0.8009858287122612
Nb de leçons en commun avec G1 :5
Nb de lieux variants en commun avec G1 :6

Nb de leçons en commun avec M1 :13
Nb de lieux variants en commun avec M1 :13

Nb de leçons en commun avec N :8
Nb de lieux variants en commun avec N :9

Lemme 	leçon
le tesmoing	les tesmoins (M1)	1
la chose	les choses (G1 M1 N)	1
sa proiere	ses proieres (G1 M1 N)	1
tel afere	ces afaires (M1)	1
la vesteüre	les vesteüres (M1 N)	1
fist	firent (G1 M1)	1
vit qe	virent que (M1)	1
parloit	parloient (M1 N)	1
devoit	devoient (M1)	1
prestres	prestre (G1 M1 N)	1
estoit venuz li proioit	estoient venu li prioient (G1 M1 N)	1
l'oï	les oï (M1 N)	1
vint	vinrent (M1 N)	1

red.
28
Pourcentage : 1.7252002464571778
Nb de leçons en commun avec G1 :8
Nb de lieux variants en commun avec G1 :19

Nb de leçons en commun avec M1 :28
Nb de lieux variants en commun avec M1 :28

Nb de leçons en commun avec N :15
Nb de lieux variants en commun avec N :24

Lemme 	leçon
les oevres et  les vies es escripturesescriptures	les vies et les oevres escrites (M1)	1
et ensamble o soi	atout (G1 M1 N)	1
se pleinstrent et gemirent	gemirent (M1 N)	1
del seint	de (G1 M1)	1
les griez peines	paine (M1 N)	1
savoir certeinnement	savoir (M1)	1
qi a lui apertienentapartenoient	al dyable (M1 N)	1
sacrez a oés le deable et beneïzbeneïs et sacrez as deablesestablis et por faire pleinementplenierement les oevres qi a lui apertienentapartenoiental dyable	illuec establis pour faire les oevres au deale (M1)	1
com tu nos diz et mostres en cecel Deu qi tu aeures	en ton Dieu com tu dis et moustres (M1 N)	1
clinoit plus et pendoit	se clinoit plus (M1)	1
cele grant mervelle de loing	cele merveille (M1)	1
fors tant solement	fors que (M1)	1
arrester et aguetier	arrester (M1 N)	1
tres cruieus	crueuse (M1)	1
sacree et beneïe	sacree (M1)	1
un de ses iols	son oeil (G1 M1 N)	1
q'ilque par totes lesleur ceailles dea lor freres  qeïssent et cerchassentcerquascent et quesiscent	qu'il queïssent par toutes les maison de leur freres (M1)	1
la chariole, ce est la coroie	le coroie (M1 N)	1
Et encontrecontre ce disoit li deables	Li deales li respondoit (M1)	1
il vint	vint (C2 C3 M1 N)	1
fermeüre desfermer del huis	serrure desfremer (G1 M1 N)	1
d'enmi le feules flammes	du fu (M1)	1
q'il devoit morir. devant ce q'il morustsa mort	chou q'il morust le tans q'il devoit morir (M1 N)	1
qi mengoient les poissons et les devoroient	et qui devoroient les poissonciax (M1 N)	1
qi de Poitiers estoient	de Poitiers (G1 M1 N)	1
qi de Tors estoient	de Tors (G1 M1 N)	1
ou il li	et (G1 M1 N)	1
Tout ausi	si (G1 M1)	1

sing.
16
Pourcentage : 0.9858287122612447
Nb de leçons en commun avec G1 :5
Nb de lieux variants en commun avec G1 :7

Nb de leçons en commun avec M1 :16
Nb de lieux variants en commun avec M1 :16

Nb de leçons en commun avec N :11
Nb de lieux variants en commun avec N :12

Lemme 	leçon
estoient	estoit (M1 N)	2
ont	a (M1)	1
et por les granz torbes	et por le grant torbe (M1 N)	1
des genz	de gent (M1)	1
les torbes	la torbe (G1 M1 N)	1
s'asamblerent	s'asembla (G1 M1 N)	1
les torbes	le torbe (M1)	1
forces	force (G1 M1 N)	1
a eus	a lui (M1 N)	1
sa volenté	sa volenté de plusors afaires (M1 N)	1
formes	forme (G1 M1 N)	1
cez paroles	ceste parole (M1 N)	1
les flambes	le flambe (M1)	1
entendez	entende (M1 N)	1
les	le (M1)	1

temps
30
Pourcentage : 1.8484288354898337
Nb de leçons en commun avec G1 :10
Nb de lieux variants en commun avec G1 :13

Nb de leçons en commun avec M1 :30
Nb de lieux variants en commun avec M1 :30

Nb de leçons en commun avec N :22
Nb de lieux variants en commun avec N :24

Lemme 	leçon
fust	estoit (G1 M1)	3
eüst	avoit (G1 M1 N)	1
feïst	faisoit (G1 M1)	1
avoient aoré	aoroient (G1 M1 N)	1
lessoient	lessierent (G1 M1 N)	1
avoit a lui envoiez	envoioit a lui (M1 N)	1
porent	pooient (M1 N)	1
devint	fu devenus (M1 N)	1
vout	voloit (C3 G1 M1 N)	1
avenoit	avenist (M1 N)	1
oï	ot oï (M1)	1
aeuroient	aorent (M1)	1
tesmoignoient	tesmoignent (M1 N)	1
menti	mentoit (M1 N)	1
aporterent	aportoient (M1 N)	1
avoit	avoit eü (M1)	1
vousist	vouloit (G1 M1)	1
voudroit	vielt (M1 N)	1
demenoient	demenerent (M1 N)	1
fu	est (M1)	1
doit bien a vos soffire	vos doit bien souffire (M1 N)	1
et esleeciez	et si avés esté esleechié (M1 N)	1
di	ai dit (M1 N)	1
ooit	oï (M1 N)	1
entendoit	entendi (M1 N)	1
est trespassee	trespasse (G1 M1)	1
je	j'ai (M1 N)	1
m'esvellastes	m'avez esveillié (G1 M1 N)	1



om.
317
Pourcentage : 19.53173136167591
Nb de leçons en commun avec G1 :163
Nb de lieux variants en commun avec G1 :175

Nb de leçons en commun avec M1 :317
Nb de lieux variants en commun avec M1 :317

Nb de leçons en commun avec N :243
Nb de lieux variants en commun avec N :248

Lemme 
si	19
et 	18
Et	10
il	10
a	8
i	7
de	7
li	7
en	7
la	5
ce	5
meïsmes	4
se	3
qe	3
ensamble	3
Jesu Crist	3
grant	3
molt	3
les	2
mie	2
aprés	2
ja	2
a lui	2
ne	2
le	2
Un autre miracle	2
tout	2
fors	2
mout	2
por	2
devant	2
seinz	2
com	1
et bone volenté	1
et par ce	1
tuit	1
molt volentiers	1
Et 	1
l'amor	1
le jor	1
et besoigneus estoient	1
qui venoit derrieres	1
feïst bienaucun bien et 	1
n'autre rien	1
seinz	1
Jesu Criz	1
l'oevre de	1
cil	1
qiqu'il ne voloitvolt mie	1
et seisi	1
ou	1
est	1
et a la vraie creance	1
Seinz
                  Martins	1
le cors de	1
en croiz	1
fu	1
qi en  la contree estoient	1
et li evesqe.	1
amor	1
autre chose. ne	1
voie meïsmes	1
einz	1
n'	1
en nule maniere	1
lor deliz d'endroitaese de lor cors	1
com il	1
mon signeur	1
seculer	1
Miracles de seint Martin	1
et mout bien atornee	1
li seinz hom	1
s'	1
Si com seinz Martins resuscita un
              mort	1
et s'estut	1
tantl'espasse qe l'en peüst avoirestre alé	1
cil q'il avoitavoient encontrez	1
et esmervelloients'esmerveilloient	1
qant il vout	1
pleinement	1
de toz cels qi la estoient	1
lor	1
un pou loing	1
et esperdu	1
et lor proieres	1
de crestiens et autieus	1
Si com il ardi un templeun temple de paiens	1
estoient	1
la loy	1
q'il	1
et sauvee	1
Si com il abati un temple	1
s'en	1
li evesqes	1
evesqe	1
et maumis	1
et cheï	1
en tel maniere	1
environ li	1
a dire	1
en li	1
qi fust sipas dignes	1
les signes de	1
 si	1
a crier	1
le seint home	1
par la volenté de nostre Signor	1
lor valors	1
et	1
Si com il delivra le serjant au conselle	1
en sa meson	1
et crioit	1
meintenant	1
bones	1
Si com il chaça le deable hors d'une
              meson	1
 l'entree de	1
tout ardant	1
Uns miracles de seint Martin	1
qui leur disoient (#C2)	1
plus	1
et fors de doutance	1
Uns autres miracles	1
encor	1
Uns autres miracles	1
en nule maniere	1
par	1
mondee de	1
cruele	1
ensamble oa toute sa fille	1
par lui	1
Si com il rendi a un home son oel 	1
Si com il cheï del cenailldou cheval	1
li empereres	1
de Rome	1
genz	1
ce estoit	1
fete	1
aussi	1
l'en	1
si com il est encore en us et en costume	1
conté	1
si tost	1
tost	1
ne en nule forme	1
et ceste oevre	1
a la voie	1
as freres	1
oïr	1
une autre foiz par lui	1
ne ne devoit avoir de nostre Signor nule
                indulgense	1
ensamble o lui	1
l'	1
aloient entre lui et Deu: et 	1
tres	1
d'une resplendissant porpre	1
qe cil avoit vestue	1
entre eus	1
estre	1
deable	1
mes meins	1
je	1
encontre	1
nos	1
vilenie et 	1
li escondeïsse ne	1
en tot	1
beau	1
lassez de la voie	1
envers nostre Signor Jesu Crist	1
hors	1
del cors	1
mortel	1
nostre Signor	1
si dist	1
et faire	1
estre ena	1
toz tens	1
aler a nostre Seignor	1
li Poitevin	1
et une grant dissention	1
et doivent	1
seul	1
envers nos	1
de ce	1
de grant maniere	1
et entendoit	1
et la joie	1
un pou	1
et tristres	1
li arcevesqes	1
meïsme	1
trestot	1
Ci conmence la translation del corsmonseigneur seint Martin evesque	1
Ci conmence
                  la translation del cors seint
                    Martin Evesque. Aprés ce qe li seinz hommessires saint Martin dontde qui je vos ai contéconté et dit la vie fu trespassez de cest mortel
                  siecle .lxiiii. anz tout droitement fuAprés fu eslevezesleuz a archevesqes estre arcevesquesde Tors uns seinz hom. et de bone vie qi PerpetuusPropetuus estoit apelez par non. Qant il fu en la
                dignité et en la signorie, il porpensase porpenssa a fere sor le cors seint Martinde seint Martinmonseigneur saint Martin plus haute eglisse et plus bele. q'ele n'i estoit
                faite. Ce fist il par molt grant estude. et molt en aurions a parler conment
                  l'oevre fu parfaite et consomeeachevee, se nous a plus haute chose raconter
                  et dire: n'avions proposé a metre
                nostre entente. Qant ele fu toute parfete et consomee, li seinz archevesqes manda toz les voisins evesqesevesqes voisins et toz les abbés et les prestresprelas et les clers de la contree por l'eglisse dedier
                et beneïr et por le cors de saint Martin oster de la ou il estoit enfoïzde la ou il estoit enfouiz oster et metre en autre leu
                  a grant honeur,  aet a grant joie et a grant segnoriegranz seignories si com droiz estoit.  Et por cepour ce que voloit li bons archevesqesli bons evesques vouloit qe ceste translation fust fete le jor des premieres kalendes
                de juignetjuing. Il veillierent la nuit devant. et qant vint laa la matinee, il conmencierent a foïr la terre qi estoitest dit deseur le sarqusaint sarqueul, et puis si misent lorles meins tot entor por leverlaverpor lever tot entor le amont et por remuer leesmouvoir plus haut. Mes onqesainz ne sorentse sorent tant pener ne traveilliertravaillier ne esforcier q'il le peüssent removoir en nule maniere. DontAdonc furent molt dolenz et si lessierent trespasser le jor tresq'a la nuitjusques a la nuit qi venoit. Et cele meïsme nuit revellierent  iltravaillierent toute tresq'a la matineejusques a la matinee. DoncAdonc si ressaierentessaierent s'il poroient le seint cors atot le sarqu removoir nena amont treirelever ne remouvoir ne amont traire. LorsDont furent molt dolenztriste et molt espoentez, car il
                ne le pooient movoirremouvoir nen'il ne savoient q'il en peüssent
                fere. Dont parla uns des clers qide cels qi lailec estoient et si dist : DontEt ne savez vos, beausbeaubien signors, qe tresq'a tierz jordusques a tiers jour seraest la feste del jorle jour de la feste q'il reçut l'arcevesqiéle veschié, et ceste feste avoit il acostumé
                  a feire. ParEt par aventure tresq'a ce jordusques a cel jour. ne velt il c'on le remueve. Li evesqearchevesques et li clergiés qi la estoient assembleztuit li autre clergié: s'asistrents'asentirent a ces paroles, si i furent tresq'au tierz jorjusques au tiers en jeunes et en orisons et en vegiles.	1
Et qant vint au qarttierz jor, il s'aprochierents'aprochierent tuit au sarqu ou li corsli cors saint gisoit del seint home, si i mistrent toz les meins por removoir leesmouvoir et por lever lerelever, mes il ne porent. QuantEt quant il virent ce, siil furent toz espoentez: ne ne sorent q'il peüssent feire, et tant qu'il se porpenserent q'il recoverroient de terre la sepouture q'il avoient descoverte. Si comLa ou il estoient en cele doutance, uns vielz hom
                de mout grant beauté, aussi
                blans conme nois negie, s'aparut
                  a els. et il li
                demanderent qi ilq'il estoit: et il
                lor distrespondi q'il estoit uns abbes. et puis si parla et lor distleur dist tiex paroles : Por qoi atargiezacouchiez vos. et por qoi estes vos maladesdolent et tristre ? DontEt ne veez vous seint
                    Martin qi vos vient aidier. a ceste chose se voz i volez les meins metre ?  Dont
                osta li blans hom qi lailec estoit venuz s'afubleüresa vesteüre. et li prestretuit li prestre aussi qi la estoient et li vesqe, et les seintes reliqes et les croiz
                      et .vii. cierges i furent aportez tos ardanzqui avoit aportees les croiz et les saintes reliques et .vii. cierges ardans. Dont conmencierent l'anteveneune anthiene a chanter. et si leverent le sarqu del seint home en haut molt
                  legierement. par l'aïde del viel home, si l'emporterent et misent elen un leu ou il estoit aoreza esté  tresq'a hui cest jorjusques a ores. Et qant il fu mis et assis en son lieutornez et conreez a la volenté de l'evesqe qi Perpetuus avoit nondu saint archevesque qui propetuus estoit apelez. et la messe fu
                  chantee. et il se furent assamblé por mengier ensamble si com il estoit costume adonqes, il manderentdemanderent le viel home qi aidié lor avoit, mes il n'en troverent mie. ne il n'estoit la nus homn'i ot celui qi l'eüst veü issir de l'eglisse. 	1
Por ce croi jecrei je biencroi je veraiement qe ce fu aucuns angeles qi por le seint hom s'aparut ilueqess'apparut pour le saint home ilec voiant touz cels qui
                    y estoient, et sine ne s'aparut onqes puisplus a nul d'eus de cels de l'eglissequi en l'eglise estoient. Et en icelcest leu ou li cors del seint home fu mis avindrentvindrent tres ce jor en avant meint beau miracle. qi par negligence sont lessié en escripture a metrea metre en escripture. Mes nos en
                  avons conté et dit: ce qe nos en avons en nostre tens veüveïsmes en noz tans: et qeet ce que nos en oïmes conter par autruipar autres conter: et ce qe nos
                en deümesdevons veraiement croire. par l'aïde nostre
                  Signor. qi vit et regne par tos les siecles des sieclesdes siecles sanz fin. Amen.	1



Leçons d'ordre sémantique (945)
Pourcentage : 58.225508317929766
Nb de leçons en commun avec G1 :273
Nb de lieux variants en commun avec G1 :533

Nb de leçons en commun avec M1 :945
Nb de lieux variants en commun avec M1 :945

Nb de leçons en commun avec N :577
Nb de lieux variants en commun avec N :729

Lemme 	Leçon
ensamble	avec (G1 M1)	22
Si	et si (M1 N)	15
Lors	Dont (G1 M1 N)	10
i	il (G1 M1 N)	10
ne	et (M1)	8
non	ne (M1 N)	8
en	a (M1)	7
la	le (C2 C3 G1 M1 N)	7
trestoz	si (G1 M1 N)	6
fors	hors (M1)	6
del	de (M1)	5
environ	entor (M1)	5
vers	encontre (M1 N)	5
Si com	La ou (G1 M1 N)	5
tres	des (M1)	4
cil qi	qu'il (G1 M1 N)	4
a	por (M1)	4
environ	entour (M1)	4
le	li (M1)	4
si com	la ou (G1 M1 N)	4
q'il	qui (M1)	4
envers	vers (M1 N)	3
ert	estoit (M1 N)	3
deguerpir	guerpir (C2 G1 M1 N)	3
tresc'a	dusc'a (M1)	3
une	cele (M1)	3
ore	encore (M1)	3
trestoz	touz (G1 M1 N)	3
d'une	du (M1)	3
Qant	Et quant (G1 M1)	3
l'avoit	avoit (M1 N)	3
il fu	fu il (M1)	3
Maximiens	Maximes (C3 G1 M1)	3
Qant	Et qant (M1 N)	3
dedenz	en (M1)	3
ne	n'en (M1)	2
lors	adont (M1)	2
soi	lui (G1 M1)	2
en coi	dont (M1 N)	2
li	et li (M1 N)	2
Adonc	Atant (M1)	2
nostre Signor	de Dieu (M1 N)	2
Li	Et li (M1 N)	2
seinz	saint home (G1 M1 N)	2
il	li sains hom (M1 N)	2
ceaille	loge (M1)	2
tresq	dusqu'a (M1 N)	2
trestuit	tuit (G1 M1 N)	2
et nient	nient (M1 N)	2
Si	Et (M1 N)	2
ou	on (M1)	2
bien	riens (M1 N)	2
seinz Martins	li saint hom (G1 M1 N)	2
en tel maniere	ainssi (M1 N)	2
par	pour (M1 N)	2
fole	males (M1)	2
sa celle	son habitacle (M1)	2
conmença	dist (M1 N)	2
et 	et que (M1)	2
en	seur (M1)	2
vraie	sainte (G1 M1)	2
enemis	deables (G1 M1 N)	2
ensamble lui	avec lui (M1 N)	2
hauz cuens	plusors (G1 M1 N)	2
les	ches (M1 N)	2
grant	bone (M1 N)	2
q'	com (C2 C3 M1 N)	2
ja tant	ja (G1 M1 N)	2
en la compaignie au	avec le (G1 M1 N)	2
a l'anemi	au deable (G1 M1 N)	2
apelez	apelez par non (G1 M1 N)	2
Anatolius	Natholius (M1 N)	2
ce	cil (M1)	2
grant piece le tens	devant (M1)	2
Meintenant	Et tantost (M1 N)	2
tresq'au	dusc'au (M1 N)	2
dementieres	endementres (G1 M1)	2
De .seint. Martin	Cest la vie de saint Martin vesque (M1)	1
mout doit on  doucement et volentiers le bien oïr et entendre	Cascuns crestiens doit bien oïr et entendre volontier le bien (M1)	1
par le  bien savoir et retenir	por le bien oïr et savoir et retenir (M1 N)	1
en totes lor vies	en leur vivant (M1)	1
poindera	prendra (G1 M1)	1
aisé	assasé (M1)	1
richesces et avoirs	avoir et richoises (M1)	1
deables	anemi (M1 N)	1
et pris	et loiés (M1 N)	1
q'il les enmeine	qui les enmeine (C3 G1 M1 N)	1
gardent	garderent bien (M1 N)	1
tormenz	martires (M1 N)	1
A ce regarderent	a ce pristrent garde (G1 M1 N)	1
et 	meesmement (M1)	1
dont ci comence la vie	dont je vos conterai ichi la vie (M1)	1
Ysabbarie	Ysapharie (G1 M1 N)	1
l'en detint et retraist	le detint et fist atargier (M1 N)	1
docement	devotement (M1 N)	1
enfanz avoient: chevaliers les
                feïssent.	avoient les enfans en feïssent chevaliers (M1)	1
ne nule folie	de nule felonie (M1 N)	1
. et douçour. et pitié. et 	douce et debonaire et (M1)	1
l'umanité	l'umilité humainne (M1 N)	1
si ert il si douz et si pius	si ert il dolz et pius (C3 M1 N)	1
resembloit	sambloit (G1 M1 N)	1
signorie et reverence	amor et seignorie (M1 N)	1
ne por qant	et ensivoit (G1 M1 N)	1
cels	tous chiaus (M1 N)	1
revestoit	vestoit (G1 M1 N)	1
mestier	soffraite et besoing (M1)	1
ores	al jour d'ui (M1)	1
combien	combien de tans (M1)	1
chevauchierent un jor par la cité	chevalcherent par mi la cité un jor (M1)	1
parvindrent	vindrent (G1 M1 N)	1
povre 	molt povre (G1 M1 N)	1
a proieret a proier et a rover	a demander et a requerre (M1)	1
trestuit	tres dont (M1)	1
n'avoient fait au povre home nul
                bien	ne faisoient nul bien au povre home (M1)	1
aucune chose	del sien por s'amor aucune cose (M1 N)	1
estoit	iert (M1)	1
son mantel par mi	son mantel parmi le moiere (M1)	1
moitié	partie (M1 N)	1
partie	moitié (M1 N)	1
le conmencierent a escharnir	le conmencherent a gaber et a escarnir (M1 N)	1
por ce	et por che (M1)	1
pluiseur	auquant (M1 N)	1
avoir fait	faire (M1 N)	1
beneoiz	bons (M1 N)	1
au povre home	au povre (M1)	1
regardast et coneüst	reconneüst (M1 N)	1
vesteüre	affubleüre (M1)	1
oï	ce oï (M1)	1
il	il meïsme (M1 N)	1
devant dite	dite avant (M1 N)	1
la bonté	le bon amor (M1)	1
en cui compaignie il estoit venuz	avec qui il estoit venus en conpaignie (G1 M1 N)	1
jusq'atant	dusc'atant (M1)	1
Endementieres	Entre ces choses (G1 M1 N)	1
contree	terre (G1 M1 N)	1
la terre	la contree (M1 N)	1
estoit costume	estoit acostumé (C2 M1)	1
Adonc	Et dont (M1 N)	1
Ne	ne ne (G1 M1)	1
droiture	drois (M1 N)	1
se trestretrest 	traist (M1 N)	1
dons	deniers (M1 N)	1
combatre	a combatre (M1)	1
de corroz et d'ire	d'ire et de maltalent (M1)	1
molt hardiement seinz Martins	sains Martins sans doutance et sans paor (M1 N)	1
ma	ta (G1 M1 N)	1
trespercerai. et trespasserai	trespercherai et passerai (M1)	1
por ce	pour ce qu'il vouloit (G1 M1 N)	1
eus	iaus meïsmes (M1)	1
volenté	volenté de (G1 M1)	1
alast desarmez ena la bataille	n'alast a la bataille tos desarmés se ele eüst esté (M1 N)	1
il vout qe la pes fust ensi faite	ja soit che cose que le pais fust ainssi faite par se volenté (M1 N)	1
seinz Martins	mesire sains Martins (M1 N)	1
en avision	une vision (M1)	1
Et	Mais (M1 N)	1
il entresait s'en iroit	que otroier li convenoit (M1 N)	1
erranment	errant (M1)	1
deguerpissoit	se partoit de (M1 N)	1
de diversitez	d'aversitez (G1 M1 N)	1
venist	parvenist (M1)	1
gaitoient	agaitoient (G1 M1 N)	1
vindrent	parvindrent (M1 N)	1
une coignie	une cuignie qu'il tenoit (M1)	1
le	l'en (M1)	1
prist	aert (M1 N)	1
comanderent	carquerent (M1 N)	1
l'enmena	le mena (M1)	1
liu trestorné	liu destolu (M1 N)	1
ensus	loing (M1 N)	1
respondi	li respondi (G1 M1 N)	1
heitiement	hartiement et dist (M1)	1
seürs	seürement (M1)	1
fiance	point de fianche (M1)	1
crut	fu convertis et crei (M1 N)	1
orast	priast (M1)	1
Aprés	Et aprés (G1 M1 N)	1
tote sa voie	tout son chemin (G1 M1 N)	1
trespassé	passé (C2 C3 G1 M1 N)	1
son chemin	mi sa voie (G1 M1 N)	1
dist	respondi (M1 N)	1
cest ver del Sautier	chest ver qi est el psaltier (M1)	1
deables	anemis (M1 N)	1
q'a	qu'en (M1)	1
ensivoient	menoient (M1)	1
s'en revint adonc	Lors s'en revint messires sains Martins (M1 N)	1
fist	et fist (G1 M1)	1
arrester	illuec arrester (M1)	1
lonc	grant (M1 N)	1
creanz	en creance (G1 M1)	1
repairiez	revenus (M1)	1
si ert soudainement morz	et si estoit si soudainnement mors (M1 N)	1
la cheaille	la loge (M1)	1
environ	tout entour (G1 M1 N)	1
riule	le riule (M1 N)	1
nostre	de nostre (G1 M1 N)	1
seint	beneoit (M1 N)	1
la dedenz	laiens (G1 M1 N)	1
se movoient	li movoient (M1 N)	1
les	ses (M1)	1
oïrent	virent (M1)	1
defors	par dehors (M1 N)	1
la ceaille	le loge (M1)	1
cui il	et qu'il (M1)	1
avoient lessié n'avoit se pou non devantde tens sans vie	avoient orendroit laissié mort (M1)	1
rot	ot (C2 C3 G1 M1 N)	1
premerains	premiers (M1 N)	1
si com	avint que (M1)	1
oï	i oï (M1)	1
grant noise de plor et de cri	grant plour et grant noise (M1 N)	1
torna	torna laiens (M1)	1
si estoit	s'estoit (C2 C3 G1 M1 N)	1
et tolue la vie	courant (M1 N)	1
gisoit morz	gisoit qui estoit mors (M1)	1
issir toz cels qi en l'ostel estoient hors	issir hors tous ciax qui en la maison estoient (M1)	1
avoit esté	gisoit (M1 N)	1
estant	en son estant (M1)	1
au porche	le porte (M1 N)	1
le voloient cil de Tours	avint que cil de Tours le voloient (M1)	1
Rurtius	Ratticius (M1 N)	1
avoit non	avoit a non (C2 M1 N)	1
qi a sa feme iert prise	qui tenoit se feme (M1 N)	1
por	d' (M1 N)	1
venir	aler (G1 M1 N)	1
de Tors tant seulement	de la tant seulement (M1 N)	1
de l'eveschié	des evesques (M1 N)	1
trop laidement	vilment (M1 N)	1
vileinement	laidement (G1 M1 N)	1
de povre persone	povre persone avoit en lui (M1 N)	1
nostre Sires	Dex (M1 N)	1
meint	tant (M1 N)	1
et en abiten l'abit de moigne	ainz (G1 M1 N)	1
il l'eveschié	le seignorie del evesquié en abit de moine (M1 N)	1
venoient	venoit qu'il ne pooit souffrir en nule maniere (M1)	1
vousist	desirroit (G1 M1 N)	1
avoir	a avoir (M1 N)	1
de l'autre	d'autre (M1 N)	1
d'une part d'	par (G1 M1 N)	1
deciple	si desciple (G1 M1 N)	1
l'amoient	amoient lui (G1 M1)	1
freres	desciples (G1 M1 N)	1
nus	nus d'iaus (M1 N)	1
fors seulement d'enescritures	fors tant seulement des escritures (M1 N)	1
a cele oevre s'estoient	a cele oevre faire s'estoient (M1)	1
erent en abstinence	s'en atenoient (G1 M1)	1
conmant	conmandement (M1 N)	1
et si erent	li ancien estoient (G1 M1 N)	1
de sa ceaille	hors de son habitacle (M1)	1
s'assembloient	assambloient emsamble (M1)	1
Tuit manoient ensamble	Tout ensamble mengoient (M1 N)	1
venue	venue de mengier (M1)	1
n'i	il n'i (M1)	1
poil	soies (C3 M1 N)	1
avoit ensamble o eus	entreuls avoit (G1 M1 N)	1
molt eüssentfeïssent bien al siecle lor volentez	avoient bien pooir d'avoir au siecle lor volentés et lor aises de lors
                cors acomplis (M1)	1
conqerre	a conquerre (M1)	1
pluiseur	auqant (M1 N)	1
des	d'eus (C2 M1 N)	1
covoitast	covoitast et desirrast (M1)	1
le dïent	di je (M1 N)	1
finir	morir (M1 N)	1
empriés	aprés (G1 M1)	1
de seint Martin	de mon segneur saint Martin (M1 N)	1
pasteur	mestre (G1 M1 N)	1
avoient	i avoient (M1)	1
Si	ou (G1 M1 N)	1
veü meintes foiz	souventes fois veü (M1 N)	1
une eglyse	l'eglise (M1 N)	1
en i eüst pluiseurs autres	i en geüst d'autres (M1)	1
et sanz doutance	certainement et sans doutance (M1)	1
les clers	les clers anciens (M1)	1
creature reson	certaineté (G1 M1 N)	1
nule chose	nule verité (M1)	1
n'ert	n'en savoit (M1)	1
certeins	seurement (M1 N)	1
a	et a (M1)	1
par devers	devers (M1)	1
jouste	delés (M1 N)	1
lez et hisdeus et cruel	lait et noir et cruel (M1)	1
conmanda	demanda a chelui (M1)	1
et ensamble o	et avec (M1 N)	1
celui parler	bien chou que cil disoit (M1)	1
qi ensamble o lui estoient	qui estoient avec lui (M1)	1
cele fole	fole (M1 N)	1
cele malvese	malvaise (M1 N)	1
aloit	s'en aloit (M1 N)	1
portoit	enportoit pour (M1)	1
s'arresta	aresta (M1)	1
se fu arrestez	ot alé (M1 N)	1
estoit	pooit estre (M1 N)	1
aperçut	perchut (M1 N)	1
cuida	quida et crut (G1 M1 N)	1
costume	acoustumanche (M1 N)	1
soloient	la souloient (G1 M1 N)	1
comportoient	portoient (G1 M1 N)	1
Por	Et en (M1)	1
ce	il che (M1)	1
fist	fist il (M1 N)	1
se ce	che (M1)	1
a terre	jus a terre (G1 M1 N)	1
aussint com	et furent (M1 N)	1
conmença li uns l'autre a esgarderregardera regarder	conmencherent a esgarder li uns l'autre (M1)	1
Ensement	Ainsi (M1 N)	1
vertu	le volenté et par le vertu (M1 N)	1
avint	il avint (M1)	1
li hom	li seinz hom (C3 G1 M1 N)	1
mescreanz	gens mescreant (M1)	1
a trenchier	a couper (M1)	1
q'il nel trenchast nenane n' abatist	a couper et a abatre (M1)	1
par la volenté de Deu le temple aidié a destruire	souffert par le volenté de Dieu le temple a despechier (M1 N)	1
li desfendoient a trenchier	li deffendoient a couper (M1)	1
devoit	le devoit (M1 N)	1
lui	a lui (M1)	1
covenoit	voloit (M1 N)	1
trenchier et abatre	abatre et couper (M1)	1
uns	li uns d'iaus (M1)	1
des plus  hardiz	qui plus hardis estoit (M1 N)	1
recevoir	recuellir (M1)	1
vendra trebuchant	venrra trebuschant de grant ravine (M1 N)	1
diz et contes	contes et dis (M1)	1
en tel liu estoit	en cel liu estoit (M1 N)	1
lor arbre a trenchier mout liement. et a grant joie por abatre	par grant amor et par grant joie leur arbre a couper por abatre (M1)	1
comencierent	prisent (M1 N)	1
escroller	crouller (M1 N)	1
estoient	en estoient (M1)	1
avoient	en avoient (M1 N)	1
doutance	doute (G1 M1 N)	1
estoit granz et pesanz	molt pesoit (M1 N)	1
et de nule rien n'ert sostenue	ne n'iert de nule part soustenus (M1 N)	1
tant pesoit	qui de si grant pesantume estoit (M1)	1
retorna	torna (M1)	1
pou	un poi (G1 M1 N)	1
estoient	s'estoient (M1)	1
mis por esgarder	mis a lor avis por esgarder (M1)	1
li	tuit li (G1 M1)	1
se tornerent	s'atornerent (G1 M1 N)	1
creance	esror (M1 N)	1
ou eglyse	et eglises (M1)	1
Et en cel leu ou	Et la ou (G1 M1 N)	1
beau	molt bel (M1)	1
molt ancien	anchien (M1 N)	1
un leu	une voie (G1 M1 N)	1
creoient	creoient mie (M1 N)	1
desmesuree	a desmesure (M1)	1
a demener	a mener (M1 N)	1
procheine del temple	molt pres del temple (M1)	1
tost	molt tost (M1 N)	1
esprise	arse (M1 N)	1
errant	errament (C2 G1 M1 N)	1
peüssiez	repeüssiez vos (M1)	1
garantie	garie et salvee (M1)	1
Si prioit	Et si prooit (M1 N)	1
celtel temple depecier par sa force	cel temple a forche pechoier (M1 N)	1
devine	digne (M1)	1
Dont	Adont (M1 N)	1
meinz	poins (M1)	1
escuz	et escuz (G1 M1 N)	1
chevaus	destriers (M1 N)	1
richement coverz de molt beles covertures	de molt bele faiture (M1 N)	1
desconfeïssent	les desconfesissent (M1 N)	1
encontre	contre (G1 M1 N)	1
la emplist	l'empreist (M1 N)	1
si debrisa et destruist	si l'abati et debrisa (M1 N)	1
tresqe el fondement	dusc'au fondement (M1 N)	1
tuit li paien	li assamblee des paiens (M1 N)	1
l'evesqe	le saint evesque (M1)	1
distrent	si disent (M1)	1
euz	eles (M1)	1
conterai	raconterai (M1)	1
aprés d'un autre miracle	un autre miracle aprés (M1)	1
en us et en costume	a us et a coustume (M1 N)	1
mout de vileinz	une grant torbe de vilains (G1 M1 N)	1
se fist hardi	hardi estoit (M1 N)	1
encontre	arriere (G1 M1 N)	1
mes il abandona	et si leur abandonna (M1)	1
coup	espee (M1 N)	1
q'a poi	si durement qu'a poi (M1 N)	1
gisoit	gisoit a terre (M1)	1
proia au seint home	proia au saint home merchi (M1)	1
pardon	et pardon (M1)	1
Cis	Li (M1 N)	1
a depecier	a combrisier (M1 N)	1
a destruire	a confondre (M1 N)	1
por lui ferir d'un coutre
                et ocirre	atout un coltre pour lui ferir et ochirre (M1 N)	1
tuer le seint home	pour lui ferir (G1 M1)	1
Deu	nostre Seigneur (M1)	1
faisoit	leur fesoit (G1 M1)	1
destruire et depecier	despechier et confondre (M1)	1
tieus poissance	si puissanz (G1 M1)	1
estoit en lui	avoit il (M1 N)	1
et curer	par le volenté de nostre Seigneur (M1 N)	1
tuit cil qui  a lui venoient i recevoient
                santé	nus malades ne venoit a lui qu'il n'eüst molt tost se santé
                recovree (M1)	1
palezins avoit	del enfermeté de palasin iert (M1)	1
enfermeté	maladie (M1 N)	1
proisme	ami (M1 N)	1
gardoient	atendoient (M1 N)	1
en tel point	en tele maniere (M1 N)	1
molt sovent	et avoit faites (M1 N)	1
entor	ja entor (M1)	1
aavec lui venoients'assembloient	se tenoient avec lui (M1)	1
sa	la (C2 M1 N)	1
par dolereus martyre muert et perist en langor	muert par dolereuse maniere de langueur (M1 N)	1
ait ele	retiegne ele (M1 N)	1
si	et que tu (M1 N)	1
beneïs	beneïsses (G1 M1)	1
Au daerrenier	En le fin (M1 N)	1
damoisele	pucele (M1)	1
s'arresterent fors de la porte	dehors le porte arresterent (M1 N)	1
conmanda	rouva (M1 N)	1
de s'enfermeté et curee	et sanee de s'enfermeté (G1 M1)	1
la	i (M1)	1
dist	le dist le dist (M1)	1
conceles	provos (M1 N)	1
avoit non	estoit apelez (M1 N)	1
cil qi i alerent	onques (M1)	1
denz	dens eskignes (M1 N)	1
li conceles	li prevos (M1 N)	1
Ce	Et che (M1)	1
encovença	ot en couvent (G1 M1 N)	1
de celui	del cors de chelui (M1 N)	1
le serjant	le vallet (M1 N)	1
Aprés ce non mie grantlonc terme trespassépassé	N'ot mie aprés che grant termine (M1)	1
vint li seinz hom	quant le sains hom vint (M1 N)	1
estoit entrez el cors	avoit pris et saisi (G1 M1)	1
meson	mesnie (G1 M1 N)	1
sanz poor	sans paour avoir (M1 N)	1
se tenist	fust (G1 M1 N)	1
qe se ce fust	qu'il feïst (G1 M1)	1
la dedenz	laienz (G1 M1 N)	1
et ne qe dent	toutevoies (M1 N)	1
cremeur	cremance (M1 N)	1
derriers	dessous (M1 N)	1
de ce fu il mout dolenz	ce fist il molt dolanz (G1 M1 N)	1
choses	oevres et ches coses (M1 N)	1
molt esmaie et torblee	molt torblee et esbahiee (M1)	1
conmanda	demanda (M1 N)	1
regehi	gehi (C3 M1)	1
s'en	se (M1 N)	1
creance	errance (G1 M1 N)	1
la citez	la cités de Tours (M1)	1
de l'enemi	del deable (G1 M1 N)	1
Un	En (M1)	1
affermez en la seinte creance	en ferme creance (M1)	1
Mes qant il	Quant il (M1 N)	1
pres que tote et 	et pres que tout (G1 M1)	1
saciez	le sachiés (M1)	1
adés	tous jors (M1)	1
la santé q'il avoit receüe	chou qu'il avoit santé recheüe (M1 N)	1
la vie	de la vie (M1 N)	1
avoit non	estoit apelés par non (M1 N)	1
Si	Cil (G1 M1 N)	1
n'en cuidoit	ne quidoit (M1 N)	1
par	par mi (M1)	1
coment	pour quel maniere (G1 M1 N)	1
je ne vous sai dire	je ne vos sai a dire (M1)	1
qant	que (M1)	1
la poitrine	le piz (G1 M1 N)	1
qi la destreignoit	fors de son cors et ensus de li cachie (M1 N)	1
si	molt (G1 M1)	1
sa fille	la damoisele (G1 M1 N)	1
par la volenté	par l'umilité et par le volonté (M1)	1
au a un home son
                oel seint home	a li (G1 M1 N)	1
la doleur	l'ardour (M1)	1
l'avoit grevé	li estoit aggrevee (M1)	1
rien	goute (G1 M1 N)	1
toucha	atoucha (G1 M1)	1
son oel	a son oel (M1 N)	1
lonc tens avoit portee	avoit lonc tans eüe (G1 M1 N)	1
contreval	qu'il fist contreval (G1 M1 N)	1
mout	tous (M1 N)	1
del chaïement	de le keeüre (M1)	1
d'aler contantrecontant	de raconter (M1)	1
et de dire	ne de dire (M1)	1
raconter	conter (M1 N)	1
Il avint	La nuit (M1)	1
puis	pour ce (G1 M1 N)	1
blandissoient	blasmoient (M1 N)	1
les apostres	le maniere des apostres (M1 N)	1
n'orent poor de princes	n'orent ainc paor de prinches (M1)	1
meintes foiz	par maintes foies (M1)	1
et 	mes (G1 M1 N)	1
table	sa table (G1 M1)	1
del empire	ne l'empire (G1 M1 N)	1
la besoigne	l'essoine (M1)	1
la volenté	l'aïe (M1)	1
deffendu	par sa volonté deffendu (M1)	1
en	envers (G1 M1 N)	1
la pleniere bataille	pleniere bataille (G1 M1 N)	1
ensamble o lui mengeroit	mengeroit avec lui (G1 M1 N)	1
si grant joie l'en crut	et a grant joie (M1)	1
qe meintenant manda il	manda il maintenant le saint home. Il manda (M1 N)	1
homes	contes (M1 N)	1
longuement	grant piece (G1 M1 N)	1
premier	primerain (C2 C3 M1 N)	1
pluiseurs	ne sai qans (G1 M1 N)	1
serjanz	vallés (M1)	1
s'agenoilla	conme coustume estoit s'agenolla (M1 N)	1
Li empereres	Et li empereres (M1 N)	1
beü	le coupe recheüe (M1 N)	1
si	et puis (M1 N)	1
bailla la coupe	le bailla (G1 M1 N)	1
venuz ertestoit venuz en sa compaignie	et qui avec lui estoit venus en compaignie (M1)	1
de haute lignie et acompliz de grant richescede haute seignorie et riches	de haute seignorie et de noble lignie et acomblés de grant
                richoise (M1 N)	1
Averont	auront (C2 C3 M1 N)	1
joie	tel joie (C2 M1 N)	1
Tel signorie et tel hautesce	si grant bien et si grant hautesche (M1)	1
sauroit	porroit (M1 N)	1
Ja tant ne s'en entremetroit (#C2)	Chertes bon porçachier feroit (M1 N)	1
Riches, povres	Riche et povre (M1)	1
la venir ne pense	parvenir n'i pense (M1 N)	1
certes	entrés (M1 N)	1
doit nestre	sieut venir (M1)	1
environavec lui estoient	al mengier seoient (M1)	1
seinz Martins	mesires sains Martins (M1)	1
seüst	che seüst il (M1 N)	1
premiere	premerainne (M1)	1
auroit	il aroit (M1)	1
Valentinien	l'empereor Valentinien (M1)	1
raconte	dist et raconte (M1 N)	1
onques	onques si tost (G1 M1 N)	1
trespassa	passa (G1 M1 N)	1
meintes choses	molt de coses (M1 N)	1
tout plenierement	tout apertement (M1 N)	1
ne s'i seüst atapir	si ne s'i seüst quatir (M1)	1
boidissant	bruiant (G1 M1 N)	1
ensanglenté	ainssi ensanglenté (M1 N)	1
reconta	conta (G1 M1)	1
Et puis	Et puis si (M1 N)	1
Il	Chil (M1 N)	1
revindrent	si vindrent (M1)	1
nus	nus moines (G1 M1 N)	1
defailloit	failloit (C2 M1 N)	1
noncierent	conterent (M1 N)	1
li seinz hom	saint Martin (G1 M1 N)	1
une partie d'els aler encontre	qu'une des parties d'els alast encontre (G1 M1)	1
li auqant	li plusour (M1 N)	1
por aler encontre celui	a aler encontre (M1)	1
pas mout loing alé	mie granment aleé (G1 M1)	1
q'a pou	que pres (M1)	1
desjoins del jou	de son judicion (M1)	1
li jous	li vis (M1)	1
cornes	as cornes del buef (M1)	1
la	sa (G1 M1)	1
einsi parlé	ce dit et ces paroles racontees (M1)	1
celui qerre	aler querre chelui (M1)	1
s'entremetoit	se melloit (M1 N)	1
se tresmuoit il et aparoit	se mostroit il et aparoit (M1 N)	1
disoit	faisoit et disoit (M1)	1
il	li deales (M1 N)	1
disoit erent males	li disoit a haute vois estoient malvaises (M1 N)	1
se movoit il mie dedenz son cuer ne ne trestornoit	s'en movoit il dedens son cuer ne ne mostroit nul samlant (M1)	1
estoient	estoient par lui (M1 N)	1
recomençoit	conmençoit (G1 M1 N)	1
deça en arriere	d'arriere (M1 N)	1
cil	tuit cil (G1 M1)	1
tieus	ces (M1 N)	1
qe tu t'en repentisses	et tu te repentoies (M1 N)	1
par lui pardon	merchi par lui (M1)	1
seinz hom	prodom (M1 N)	1
Bien	Et bien (M1)	1
sa paroleproiere digne	dignes en se parole (M1)	1
novelement	n'avoit mie lonc tans (M1)	1
lessa quanq'il avoit	deguerpi toutes ses choses terrienes (G1 M1)	1
Pluisors	Et plusor (M1 N)	1
avoient	avoient mis (G1 M1 N)	1
pleinement	du tout (G1 M1 N)	1
Li jovenceaus	Clarus li prestres (M1 N)	1
demora	si demora (M1 N)	1
la	ilec (G1 M1 N)	1
par ce il	par ce qu'il (C2 C3 G1 M1 N)	1
de bone loy et de seinte vie	de bone loy et de bone creance (M1)	1
creance	bone vie (M1)	1
seinz hom	prodons (M1 N)	1
ne pot onques estre menez a ce	ne peüt onques a ce estre menés (M1 N)	1
icez	itex (M1 N)	1
sera	me sera (G1 M1)	1
et tramise	et deschendue (M1 N)	1
la celle	li lieus (M1 N)	1
meintes	plusieurs (G1 M1 N)	1
c'on i veoit	qi veües i estoient (M1)	1
s'abitation	sen habitacle (M1 N)	1
Puis	Et puis (M1)	1
molt blanche	de grant blanchor (G1 M1)	1
si c'on	si com (C2 M1 N)	1
tresc'a	dusq'a (M1)	1
ne qe dent	toutes heures (M1 N)	1
n'osoit	n'osoit mie (G1 M1 N)	1
mostrer devant lui	devant lui moustrer (M1 N)	1
q'il ne se pooit envers lui
                covrir por pooir qu'il eüst	qe encontre lui ne se pooit il couvrir de nule cose (M1 N)	1
engignier	sousduire (M1)	1
recomencierent	conmencierent (G1 M1 N)	1
li pluisor	li plusor des freres entriaus (M1)	1
entremis	meslez (G1 M1 N)	1
venuz	avenus (M1 N)	1
ot	ot che (M1)	1
par lor folies	par le païs (M1 N)	1
dist	lor dist (M1 N)	1
conme	si conme (M1 N)	1
de	hors de (G1 M1 N)	1
aproce	aproisme (M1)	1
sa celle	en son habitacle (M1)	1
premiers	premereins (C2 C3 M1 N)	1
et corone	et coronne d'or (M1 N)	1
cez	toutes les (G1 M1 N)	1
la celle	li habitacles (M1)	1
grant	tres grant (M1)	1
Por	Et por (G1 M1 N)	1
meintes	pluseurs (G1 M1 N)	1
il estoit	c'estoit (G1 M1 N)	1
vertus	grans vertus (M1 N)	1
son seint mengier	se table (M1 N)	1
ja (#C3)	ije (C1 C2 G1 M1 N)	1
regehir	gehir (M1)	1
conter	raconter (M1)	1
n'osions	nos n'osiesmes (M1)	1
ester de	refuser a (M1)	1
chose	çou (G1 M1 N)	1
siecle	monde (G1 M1 N)	1
pluiseurs	maintes (G1 M1 N)	1
noient	rien (M1)	1
costume	acostumé (G1 M1)	1
joste	encoste (M1)	1
firent il	si firent (M1 N)	1
de fuere	d'estrain (M1 N)	1
apris n'acostumé	a us n'a coustume (M1 N)	1
por	Et pour (G1 M1 N)	1
q'il	qant il (M1)	1
tele molece	tel moleche et si soef (M1 N)	1
le fuerre	l'estrain (M1 N)	1
esprist el fuerre	prist en l'estrain (G1 M1 N)	1
guetoit	gardoit (G1 M1)	1
l'agaitoit et destraignoit	le gaitoit et destraignoit  (M1 N)	1
qi estoit clos et serrez	dont li huis estoit serrés et clos (M1)	1
signum crucis	le signe de le sainte crois (M1 N)	1
Tantost	Et maintenant (M1 N)	1
grever	grevanche (M1 N)	1
defors	dehors (G1 M1 N)	1
Dex	nostre Sire (G1 M1 N)	1
en plorant	tout en plourant (M1 N)	1
croiz	sainte crois (M1)	1
qui c'onqes	que qui onques (G1 M1 N)	1
ne	nul (M1)	1
ceste	toute (G1 M1)	1
deci	d'ore (M1)	1
mes	a mes (M1)	1
lonc tens	longuement (G1 M1 N)	1
feire la pes	faire pais (M1 N)	1
neqe dent	toutes voies (G1 M1 N)	1
l'assomement	assomemens (M1 N)	1
ainz	ainçois (G1 M1 N)	1
q'il issist de ceste vie	qu'il de cheste vie trespassast (M1)	1
ensamble o	a toute (M1 N)	1
aloient	s'en aloient (G1 M1 N)	1
dejoste	selonc (M1 N)	1
poez	poés vos (M1 N)	1
qi	li diales (M1 N)	1
guetent	agaite adés (M1 N)	1
noient. ne sont	ne sont pas (M1)	1
ne	et qui (M1 N)	1
desertesdiverses regions	desers lius (M1)	1
repoez	poez (G1 M1 N)	1
aussi	tout aussi (M1)	1
par	partout (M1 N)	1
autel	autretel (M1 N)	1
ensamble	en une torbe (M1 N)	1
oiseaus	les oisiaus (M1 N)	1
Aprés	Après ce (C3 G1 M1 N)	1
el	au (G1 M1 N)	1
meintenant	tantost (G1 M1 N)	1
et se	si se (M1 N)	1
mie	mie a toi (M1 N)	1
tens	jors (M1 N)	1
besoignables a	necessaires a (M1)	1
aler	l'aler (M1)	1
ceus	de ciaus (M1 N)	1
voloit	se vouloit (M1 N)	1
desevrez	descreüs (M1)	1
aussint	doltans (M1 N)	1
doutoit	redoutoit (M1 N)	1
un pou de vil fuerre desoz lui metre	dessous lui metre un peu de vil estrain (M1 N)	1
ne ne presçoie	ne degerpissoie (M1)	1
torner	retorner (M1 N)	1
pou	petit (M1 N)	1
il	et il (M1)	1
fil	frere (G1 M1 N)	1
resgarda	esgarda (M1)	1
dejoste soi	encosté lui (M1)	1
aperceü	percheü (M1 N)	1
cruel	crueuse (G1 M1 N)	1
hastivement	sans demoranche (M1 N)	1
del cors	hors del cors (M1)	1
lumiere	lumiere terrienne (M1 N)	1
mostroit	demostroit (C2 C3 G1 M1)	1
surrection	resurrection (M1)	1
estoient venuz et assamblez	y estoient assemblé (G1 M1 N)	1
les voiz del ciel	le vois del ciel et les angeles (M1 N)	1
retraite	conté (M1)	1
ces	tiex (G1 M1 N)	1
requerons nos et volons avoir	requerons nous et le volons avoir (M1)	1
pueent	doivent (G1 M1 N)	1
Mes	Car (M1 N)	1
cez choses qi sont petites	les coses ester qi sont petites (M1)	1
dementieres q'il	tan com il (M1 N)	1
qe ce	puis (M1 N)	1
l'eure de mienuit vint	la nuit fu venue (G1 M1 N)	1
aval	contreval (G1 M1 N)	1
repeirierent en lor contrees	s'en repairierent en leurs contrees (M1)	1
a grant joie	a grant ijoie et a grant leeche (M1 N)	1
a grant joie	a grant ijoie et a grant leeche (M1 N)	1
de paine et de doleur	dolours et paines (M1)	1
nombre	conte (M1 N)	1
trestot	tot (C3 M1 N)	1
assegure	raseüre (M1)	1
Sevrins	Severius (C3 M1 N)	1
El	Del (M1)	1
adonqes	d'adont (M1)	1
seint Martin	a saint Martin (M1 N)	1
seint Pierre de Coloigne	de saint Pere a Coloigne (G1 M1)	1
grant partie ensamble o lui	avec lui grant partie (G1 M1)	1
droit	tout droit (M1 N)	1
deviés	deviés saint Martin (M1)	1
chanter	chantans (G1 M1)	1
chanterchantanteschantans en l'air	en l'air cantant (M1 N)	1
grant joie et de grant esleecement	de grant joie et de grant leeche (M1)	1
entendoit	n'entendoit (C3 G1 M1)	1
creature	cose (M1 N)	1
qi chantoient	qu'il cantoient (M1 N)	1
Dont	Et adont (M1)	1
releverent de terre	releverent andoi de terre  (M1 N)	1
Li arcediacres	il li (M1)	1
la	les (G1 M1 N)	1
somes	si somes (M1)	1
si tres granz	granz (G1 M1 N)	1
prendre	emporter (M1)	1
savoient	le savoient (M1)	1
En	A (G1 M1)	1
tresq'a hui cest jor enluminee
                et florie	dusc'a hui cest jour enluminee et flourie (M1)	1
disoit	lisoit (G1 M1 N)	1
la leçon	espitre (M1 N)	1
ne troublez	ne torblés mie (M1)	1
et 	car (M1 N)	1
m'a	m'i a (C3 M1)	1
seulement	tant seulement (M1)	1
preudom: et seinz hom	cil sains hom preudons (M1)	1
ensamble o les angeles	avec ses angeles (M1)	1
la mere nostre Signor Jesu Crist	la haute Dame me Dame sainte Marie (M1 N)	1
ensamble o la conpagnie des seintes virges	avec la compaignie des virgenes (M1)	1
de tote chose est sires et crieres	Sires est de toute creature (G1 M1 N)	1

