Nb de leçons divergente entre l'édition et témoin :1999
Nb de leçons en commun avec G1 :548
Nb de lieux variants en commun avec G1 :961
Nb de leçons en commun avec M1 :1021
Nb de lieux variants en commun avec M1 :1263

ajout
155
Pourcentage : 7.753876938469234
Nb de leçons en commun avec G1 :35
Nb de lieux variants en commun avec G1 :93

Nb de leçons en commun avec M1 :60
Nb de lieux variants en commun avec M1 :109

Lemme 	leçon
si	et si (G1 M1 N)	2
ont	n'en n'ont (N)	1
le grant chemin plenier	le grant chemin plenier et la grant voie
                batue (G1 M1 N)	1
baptiziés	chevaliers baptisiés ne crestienés (N)	1
les nuz	les nus cui povretés destraignoit et besoigne (N)	1
qe son mantel	ne autre creature que son mantiel (N)	1
baptizier	batisier et lever (N)	1
nostre Signor	Dieu nostre Signeur (N)	1
Si	Et si (G1 N)	1
dit	dit qu'il iroit desarmés encontre les anemis si com il
                avoit mis en covenance (N)	1
encore	qui est cil qui doute que (M1 N)	1
soit plus nostre Sires puissanztouz puissanz	nostre Sires ne soit pius et misericors et
                poissans (M1 N)	1
plus	ore plus (N)	1
a vraie creance	a vraie foi et a veraie creance (G1 M1 N)	1
droite voie	a droite voie et a droit chemin (N)	1
molt	puis molt (G1 M1 N)	1
cremirai	cremira ja (N)	1
meintenant	maintenant qu'il ot ce dit (N)	1
batirent	le batirent (N)	1
granz loenges	molt grans loenges (G1 M1 N)	1
ausint	assamblé en rendirent graces a nostre Segneur (M1 N)	1
chasteaus	prochains castiaus (M1 N)	1
ne	ainc n'en (N)	1
.iiii.	li sains hom avoit .iiiic. (N)	1
en orissons	en orison et en proieres (N)	1
qele citez	quels cités u quels eglise (N)	1
example prendre	example prendre a bien faire (N)	1
ou	u on (N)	1
autres	as autres (M1 N)	1
la glorieuse vie	le glorieuse vie es chiex (M1 N)	1
alumee	alumee et arse (G1 M1 N)	1
enfoïz	desous enfouïs et ensevelis (N)	1
les genz	le pueple et les genz (G1 N)	1
genz	genz sarrazines (G1 M1 N)	1
Sires	Sires cui tu aoures (N)	1
parler	parler et dire (N)	1
et a ceste covenence se tindrent bien	et si se tenroient bien ce disent a ceste covenence (N)	1
Li moigne qi estoient deciple	il estoit molt grans a desmesure et molt estoit haut.
                Li moine qui estoient deciple (M1 N)	1
peor	grant paour (G1 N)	1
ploroient	prisent a plorer (M1 N)	1
establissoit il et faisoit	establiscoit il autels de crestiens et eglises (N)	1
le feu	le fu partot (N)	1
despire	despire toudis (N)	1
car	car bien saichiés qu' (M1 N)	1
ravaler	a devaler a tout le coup (M1 N)	1
manoient	manoient et habitoient (G1 M1 N)	1
de ses membres	de ses lés ne de ses membres (N)	1
un petit	un mout petit (N)	1
et dist soudeinement	et dist molt soldainement (N)	1
granz vertuz	grans vertus pour bien ne pour dignité qui en lui
                fust (N)	1
de	le pere a (N)	1
molt dolereusement	de molt dolereuse painne (M1 N)	1
sanz	et sans (N)	1
i ala por lui amener	i ala por le dervé amener au saint home (M1 N)	1
foi	sainte foi (M1 N)	1
et entra en un serjant de la meson	et encontra un sergent de la maison, si li entra el
                cors (G1 M1 N)	1
meüst	meüst en nule maniere (G1 M1 N)	1
chaut	tout chaut (G1 M1 N)	1
durer	durer en nule maniere (G1 M1 N)	1
des oevres au deable	del deable par les oevres saint Martin (M1 N)	1
des messagiers	de messaiges par le contree errans (M1 N)	1
cez messages	ches messaiges et ces nouveles (M1 N)	1
toz	touz celz qui la estoient (G1 M1 N)	1
delivree de l'enemidel deable	del deable delivre a toudis (N)	1
maladie	maladie qu'il avoit (N)	1
puis	puis ce di (N)	1
ot	ot il (N)	1
couchierent	couchierent en sa ciaulle (G1 N)	1
evesqes	pluseurs evesques (G1 M1 N)	1
nule	ne nule (N)	1
comandast	li conmandast (G1 M1 N)	1
lor guerissons	leur garisons et leur regnes (G1 M1 N)	1
ocioit	les occioit (N)	1
par	et par (N)	1
Li empereres si fu molt liez	molt fu Maximes li empereres liés de grant maniere (N)	1
autres	autres aprés (N)	1
de cui tous li  biens vientli biens toz viennent en terre et el ciel lassus	car de lui vient trestoz li biens qi sont el siecle
                terrien et trestous chilx el chiel lassus (M1 N)	1
de cui tous li  biens vientli biens toz viennent en terre et el ciel lassus	car de lui vient tous li biens qui est el siecle terrien et
                trestot cil del ciel lassus (N)	1
trestoz	tant com il mengerent et tout cil qui
                    servoient (M1 N)	1
rasamblees	assemblees et requises (G1 M1 N)	1
trestorner ne partir	partir ne destorner en nul fuer (N)	1
toute sanglante	toute sanglente. Dont moustra au saint home sa main
                et son braz tout sanglent (G1 M1 N)	1
Martin	Sains Martins (N)	1
moroit	moroit et qu'il ne rendoit l'ame (G1 M1 N)	1
conmença a raconter	commanda celui qu'il racontast (N)	1
qe	il lour dist que (N)	1
volt	li volt (N)	1
estoit	il estoit (N)	1
Il escoust	Il estorst, fait il, (N)	1
devant eus toz	devant tous les sains homes qui la estoient assamblé (N)	1
la croiz	le sainte crois (M1 N)	1
n'en avoit ne poor	n'avoit del deale ne paor (M1 N)	1
savoit	savoit bien (G1 N)	1
de ses freres	de ses dessiples et des freres (N)	1
seint Martin	mon signour saint Martin (N)	1
qi les	qui leur pechiez (G1 N)	1
mie avoir pardon	avoir pardoin de nostre Signour ne indulgence (N)	1
en la coupe	en l'indulgenses en le coupe (N)	1
chetis	meïsmes caitis (N)	1
verais	vrais et dignes (N)	1
venoient	et venoient (N)	1
noise	noise erramment (N)	1
apela un de ses freres	parla a lui uns de ses freres, mais il l'apela ainsçois a
                lui (N)	1
pluisors afaires	faire pluisors signes (N)	1
vraiement	cose sans doutance (M1 N)	1
cez choses avez oïes	avés oïes et entendues ces coses (M1 N)	1
a veritables	a veritables ne mie a menchoignes ne a fables (M1 N)	1
signes	grans signes (N)	1
le seint home	le saint home molt lonc tans (N)	1
chose	nule cose (N)	1
costume	adont coustume (N)	1
ne n'avoit autres coutes	seur che avoit apris a gesir li sains evesques ne
                autres kieutes (M1 N)	1
n'autres orelliers ne autres lincieus	ne autres linchex ne autres oreilhers n'avoit li sains
                hom (M1 N)	1
flamber	faire grant flambe (G1 M1 N)	1
entendi tant	tendi tant sa main et entendi tant (N)	1
grant	si grant (G1 M1 N)	1
la flambe ne li feus	les flammes ne les caulres qui estoient grandes et
                desmesurees (N)	1
Il	sains Martins (N)	1
qant	et qant (C2 C3 G1 M1 N)	1
Lors	Et qant il oïrent chou, si (M1 N)	1
desfendera	le deffendra (N)	1
li pasteur n'i sera mie	li paistres ne le deffendra ne n'i serra (N)	1
meüs en pitié	meüs par le duel qu'il faisoient (N)	1
ses deciples	de son proïsme et de ses disciples (N)	1
volentiers deguerpir	departir volontiers ne aus deguerpir (N)	1
disoit	leur disoit (G1 N)	1
ester le diable	devant lui ester le dyable (N)	1
nuisance	nuisance ne grever (M1 N)	1
Car il estoit plus blans qe leiz ne noiz negie	Il estoit plus purs et plus blans que lais ne que noif
                negie (M1 N)	1
la	en la (N)	1
et as voies	et en voies et en chemins (M1 N)	1
une grant tençon	une grans tence et une grans tens et une grans
                discentions (N)	1
oïes ses paroles	ses paroles oïes et entendues (N)	1
soffire	bien souffire (N)	1
ce	che fait (M1 N)	1
doit	doit il (N)	1
il en tel maniere	cil et estriverent en tel maniere (N)	1
poissanz est	est tous poisçans (N)	1
Quant	Et quant (G1 M1 N)	1
sachiez bien	sache bien qi ce demande (M1 N)	1
voiz	unes vois (N)	1
si entendist	entendist et si meïst en escoulter toute s'entente (N)	1
chose nule	a cele fois cose nule (N)	1
el ciel	qu'il l'enportent lasus el ciel (G1 M1 N)	1
lor compaignie	sa carnex compaignie (N)	1
com seint Martin	et aourné de si bones oevres conme sains Martins
                estoit (N)	1
l'ame	l'ame du saint home (G1 M1 N)	1
tens	tans tout droit (N)	1
de	de la cité de (G1 M1 N)	1
l'ot dite	si com il l'ot dite (N)	1
seinz Ambroses	li sains hom sains Ambroises (M1 N)	1
car	Et bien sachiez que (G1 M1 N)	1
ensamble o les angeles	ensamble le compaignie des angles (N)	1
ensamble o la conpagnie des seintes virges	ensamble le compaignie des angles et des virgenes (N)	1

casAbs
8
Pourcentage : 0.400200100050025
Nb de leçons en commun avec G1 :2
Nb de lieux variants en commun avec G1 :2

Nb de leçons en commun avec M1 :2
Nb de lieux variants en commun avec M1 :2

Lemme 	leçon
de li	li (N)	1
nostre Signor	de nostre Seigneur (G1 N)	1

erreur
4
Pourcentage : 0.2001000500250125
Nb de leçons en commun avec G1 :0
Nb de lieux variants en commun avec G1 :1

Nb de leçons en commun avec M1 :0
Nb de lieux variants en commun avec M1 :1

Lemme 	leçon
s'il ertestoit	s'il estoit s'il estoit (N)	1
Maximiens	Marines (N)	1
seinz	sains sains (N)	1

etym.
24
Pourcentage : 1.2006003001500751
Nb de leçons en commun avec G1 :12
Nb de lieux variants en commun avec G1 :12

Nb de leçons en commun avec M1 :13
Nb de lieux variants en commun avec M1 :13

Lemme 	leçon
ert	estoit (G1 N)	11
erent	estoient (M1 N)	6
estoit	ert (N)	4
n'ert	n'estoit (M1 N)	1
estoit	iert (M1 N)	1
n'estoient	n'ierent (M1 N)	1

inv.
137
Pourcentage : 6.8534267133566775
Nb de leçons en commun avec G1 :33
Nb de lieux variants en commun avec G1 :60

Nb de leçons en commun avec M1 :72
Nb de lieux variants en commun avec M1 :87

Lemme 	leçon
mie encore	encore mie (N)	2
les oevres et  les vies es escripturesescriptures	les vies et les oevres en escriture (N)	1
YsabbarieYsapharie avoit nonestoit apelez	qui avoit non Ysapharie (N)	1
et de par mere et de par pere	et de par pere et de par mere (G1 M1 N)	1
qi le servoit tant seulement	tant seulement qui le servoit (M1 N)	1
c'on en lui veoit	que on veoit en lui (M1 N)	1
si grant bien fait	fait si grant bien (N)	1
vestuz estoit	estoit vestuz (G1 M1 N)	1
li sovint il	il li sovint (N)	1
et livroisons asa ses chevaliers	as chevaliers et livrisons (N)	1
estoit a venir a lendemein	lendemain estoit a venir (M1 N)	1
Li empereres, qant il oï ce, 	qant ce oï li emperieres (G1 M1 N)	1
trova bien et prova	prova bien et trova (M1 N)	1
qi gaitoientagaitoient les  trespassanzle chemin liet li corurent seure	li corurent sus qui agaitoient les trespassanz (N)	1
hauça li uns	li uns hauça (G1 M1 N)	1
en temptation estoient	estoient en temptacion (N)	1
molt li pria	li pria molt (M1 N)	1
en son cheminmi sa voie le deable	le dyable en mi sa voie (N)	1
de la seinz Martins  departiz	sainz Martins partis de la (M1 N)	1
fu mout dolenz, si conmença a plo--rer	conmença a plorer et fu molt dolanz (G1 M1 N)	1
furentfurent hors tuit	furent tout fors (N)	1
ordenez a evesqe en la cité de Tors li seinz hom	li sains hom ordenés a evesque en la cité de Tours (N)	1
devant avoit	avoit devant (G1 M1 N)	1
pres ade deus luies	a .ii.liues pres (N)	1
pres ade deus luies	a .ii.liues pres (N)	1
cheve estoit	estoit cavee (G1 M1 N)	1
il avoient geuné	jeuné avoient (G1 N)	1
fet fere un autel	fet un autel fere (C3 M1 N)	1
savoir certeinnement	certainement savoir (G1 N)	1
lestouz les anciens prestres de la contree et les clersles clers anciens	les anchiens prestres et les anciieus clers de la
                contree (N)	1
par grant amor et par  grant diligense	par grant diligence et par grant amor (M1 N)	1
creature resoncertaineté savoir	savoir certaineté (N)	1
ne savoient il nule choseriennule verité	nule rien ne savoient (N)	1
o luiensemble o liatouta, ne sai qanz de ses freres aet a cel leu meïsmes	a cel meïsme liu atot ne sai quans de ses freres (N)	1
en l'oneur de celui	a celui honour (M1 N)	1
ancien temple	temple ancien (G1 M1 N)	1
adonqes en cel tens	en çou tans encore adont (N)	1
le temple despecié	depechié le temple (M1 N)	1
et droit et lonc	et lonc et droit (M1 N)	1
l'arbre a desfendre	a desfendre l'arbre (N)	1
sacré et beneï	beneï et sacré (G1 M1 N)	1
des plus  hardizqui plus estoit hardizqui plus hardis estoit de toz cels qi la estoient	de çaus qui la estoient qui plus hardis estoit (N)	1
despisoit lor dex	lor dix despisoit (N)	1
de cheïr fere samblant	a faire semblant de chaoir (G1 M1 N)	1
li seint non nostre Signeur Jesu Crist a anoncier	a anuncier le saint non nostre Signour (N)	1
mostier ou eglyseet chastiaus et egliseset eglises	moustiers et eglises (N)	1
por lui un beaumolt bel miracle	bel miracle pour lui (N)	1
i estoient soventes foiz joïessouvent veües et celebrees	soventes fois i estoient joïes celebrees (M1 N)	1
li venz comença	conmencha li vens (M1 N)	1
estoitiert procheine del templedu temple molt prochainemolt pres del temple	del temple estoit mout proçaine (N)	1
Une autre foiz avint	Lors avint une autre fois (M1 N)	1
creoit et aoroit	aouroit et creoit (G1 M1 N)	1
totes genz doivent	devoient toutes gens (M1 N)	1
contremontamont l'espee	l'espee contremont (M1 N)	1
arrierea terre toz estenduz	touz estenduz arriere (G1 M1 N)	1
fu il	il fu (N)	1
ot le colp entesé	ot entesé le cop (M1 N)	1
en la cité venuz	venuz en la cité (G1 M1 N)	1
au seint home por reqerrepor le reqerre	pour requerre au saint home (G1 M1 N)	1
et ce dire	et dire çou (N)	1
li fu la parole rendue par la volenté de nostre Signor	par la volenté de nostre Seigneur li fu la parole
                rendue (G1 N)	1
entrez el cors	el cors entrés (M1 N)	1
meïst sa mein qi dervez estoit	qui dervés estoit mesist sa main (N)	1
puissance de lui traveillier	de lui travaillier puissance (G1 M1 N)	1
fist	fist erramment (N)	1
plus n'i osa	n'i osa plus (N)	1
devorer et ocirre as denz	as denz devorer et ochirre (M1 N)	1
arriere mout tost	molt tost arriere (G1 M1 N)	1
devant lui venir	venir devant lui (M1 N)	1
le nés et la bouche	et le bouce et le nés (N)	1
un pou de ses vesteüres avoient	avoient un peu de ses vesteüres (M1 N)	1
ceste vie entendent	entendent ceste vie (G1 M1 N)	1
la lumiere receüe	recheüe le lumiere (M1 N)	1
montés en un cenaillchevalsolier par une eschiele	par une eschiele montés seur un cenaile (M1 N)	1
santé receüe lendemein	lendemain santé recheüe (M1 N)	1
une foiz lessesches paroles	ces paroles une fois (N)	1
devant l'empereor tenoit la coupe d'or	la coupe d'or tenoit devant l'empereor (G1 M1 N)	1
a la table seoit et 	seoit a la table (N)	1
de boivre aprés lui	d'aprés lui boire (N)	1
tout ce vit	vit tout çou (N)	1
devoient avenir	avenir devoient (G1 M1 N)	1
demostrer et fere	faire et demoustrer (G1 M1 N)	1
le deable einsi parler	ainsi parler le deable (G1 M1 N)	1
qeïssent et cerchassent	cerquascent et quesiscent (N)	1
au deable ceste poesté dounee	ceste poestés donee al dyable (N)	1
bien poez	si poés bien (M1 N)	1
conté et dit	dit et conté (N)	1
tous cels de lor pechiés	de leurs pechiés tous chiaus (M1 N)	1
avoir poor	paor avoir (N)	1
lor cuers et lor ententes	leur ententes et leur cuers (G1 M1 N)	1
molt volentiers celui	celui molt volentiers (G1 N)	1
veoir la	le veïr (M1 N)	1
a temptertempester seint Martin en celce  tempoiretans	saint Martin en cel tans a tempter (N)	1
en orissons toz seus	tous seus en orisons (M1 N)	1
roial vesteüre	vesteüre roial (N)	1
precieuses pierres	pierres precieuses (G1 M1 N)	1
tote doree	doree toute (N)	1
ne pas	pas ne (N)	1
ceste parole autre foiz a dire	ceste parole a dire autre fois (N)	1
cele voiz et cele parole	cele parole et cele vois (N)	1
dire au seint home de sa bouche	le saint home de sa bouche conter et dire (M1 N)	1
cuidié et dit	dit et cuidié (G1 M1 N)	1
a peines ose	oz a paine (G1 M1 N)	1
avoir lui meïsmes garanti	avoir garandit lui meïsmes (M1 N)	1
fesoit molt grant froidure	molt faisoit grant froidure (M1 N)	1
il n'ot	n'ot il (M1 N)	1
mal feire	faire mal (M1 N)	1
entendre. et savoir	savoir et entendre (N)	1
c'estce estc'estoit uns chastiaus entre Poitou et ToraineTours, se descordoientqui ainssi les desheritoient	se descordoient, Condés est un castiaus entre Poitau et
                Touraine (N)	1
q'il issist de ceste vie	que il de ceste vie iscist (N)	1
de par nostre Signor fet le conmandement	fait de par nostre Signor le commandement (N)	1
aler devoit	devoit aler (G1 M1 N)	1
remisemis la pes	le pais remise (M1 N)	1
arriere en son leu	a son lieu arriere (M1 N)	1
toutes les forces de ses membres li conmencierent a faillirdeffaillir	li conmencherent a defaillir totes les forces de ses
                membres (M1 N)	1
par les meins des seinz angeles portez	portez par les mains des sainz angles (G1 N)	1
tot aussiensement	aussi tout (M1 N)	1
tant esté	esté tant (G1 N)	1
s'ense dolousoient et jemissoientgramentoient	gemiscoient et dolosoient (N)	1
plenierement devant	devant plenierement (M1 N)	1
nos a fetes	a nous faites (M1 N)	1
n'a fait aavec nos	n'en ait avec nous fait (M1 N)	1
or lessons	laiscons ore (N)	1
certeinecerte chose	cose certe (N)	1
seint cors	cors saint (N)	1
qe un seul entre deus	entr'eus deus c'un seul (N)	1
feïssent assez	assés li feïssent (M1 N)	1
grant partie ensamble o lui	ensamble lui grant partie (N)	1
por oïr et por entendre	por entendre et pour oïr (M1 N)	1
a terre ambeduiambedui a terre ensambleensembli	andoi ensamble a tere (N)	1
oïr a l'arcedyacre	l'archediacre oïr (N)	1
el ciel demenoient	demenoient el chiel (M1 N)	1
le peüssent arrester ne tant ne qant	ne tant ne qant arrester le peüssent (M1 N)	1
l'epistre devoit lire	devoit lire l'epistle (N)	1
epistre ne leçon	lechon ne epistre (M1 N)	1
celestieus vertuz	vertus celestieus (M1 N)	1
i demeinentmainent grant joie et leesche	joie i demainent et leece (N)	1

plur.
22
Pourcentage : 1.1005502751375689
Nb de leçons en commun avec G1 :4
Nb de lieux variants en commun avec G1 :7

Nb de leçons en commun avec M1 :8
Nb de lieux variants en commun avec M1 :11

Lemme 	leçon
le	les (N)	3
la chose	les choses (G1 M1 N)	1
estoit venue	estoient venu (N)	1
fu	furent (N)	1
sa proiere	ses proieres (G1 M1 N)	1
est	sunt (N)	1
la vesteüre	les vesteüres (M1 N)	1
sa	lour (N)	1
le mal	li maus (N)	1
parloit	parloient (M1 N)	1
anemis	deable (N)	1
disoit	disoient (N)	1
son fantosme	ses fantosmes (N)	1
prestres	prestre (G1 M1 N)	1
estoit venuz li proioit	estoient venu li prioient (G1 M1 N)	1
il	et il lour (N)	1
crestien	crestiens (N)	1
l'oï	les oï (M1 N)	1
pooit	pooient (N)	1
vint	vinrent (M1 N)	1

red.
37
Pourcentage : 1.8509254627313656
Nb de leçons en commun avec G1 :7
Nb de lieux variants en commun avec G1 :24

Nb de leçons en commun avec M1 :15
Nb de lieux variants en commun avec M1 :26

Lemme 	leçon
fors tant seulement	fors (N)	2
et ensamble o soi	atout (G1 M1 N)	1
donoit tout as povres	donnoit as povres (C2 G1 N)	1
se pleinstrent et gemirent	gemirent (M1 N)	1
par le povre. qi la
                vesteüre avoit receüe	de la vesteüre que li povres avoit recheüe (N)	1
trespercerai. et trespasserai	trespercerai (N)	1
alast en son païs	iroit (N)	1
cest ver del Sautier	cest ver (N)	1
les griez peines	paine (M1 N)	1
a lor dex	lour (N)	1
sacrez a oés le deable et beneïz	establis (N)	1
qi a lui apertienentapartenoient	al dyable (M1 N)	1
com tu nos diz et mostres en cecel Deu qi tu aeures	en ton Dieu com tu dis et moustres (M1 N)	1
celui einsi	issi (N)	1
cele grant mervelle de loing	cele grant mervelle (N)	1
seinte doctrine	sainteé (N)	1
tant qe	que (N)	1
arrester et aguetier	arrester (M1 N)	1
sacree et beneïe	sainte (N)	1
un de ses iols	son oeil (G1 M1 N)	1
en sa compaignie estoit venuz	en sa compagnie (N)	1
ceste chose	çou (N)	1
por aler encontre celui	a l'encontre (N)	1
la chariole, ce est la coroie	le coroie (M1 N)	1
Et encontrecontre ce disoit li deables	Li dyables respondoit (N)	1
li evesqes puis	il (N)	1
il vint	vint (C2 C3 M1 N)	1
fermeüre desfermer del huis	serrure desfremer (G1 M1 N)	1
q'il devoit morir. devant ce q'il morustsa mort	chou q'il morust le tans q'il devoit morir (M1 N)	1
seinte Eglisse	en (N)	1
qi mengoient les poissons et les devoroient	et qui devoroient les poissonciax (M1 N)	1
conmencierent tuit a plorer	plorerent (N)	1
qi de Poitiers estoient	de Poitiers (G1 M1 N)	1
qi de Tors estoient	de Tors (G1 M1 N)	1
ou il li	et (G1 M1 N)	1
s'il	si (N)	1

sing.
15
Pourcentage : 0.750375187593797
Nb de leçons en commun avec G1 :7
Nb de lieux variants en commun avec G1 :9

Nb de leçons en commun avec M1 :11
Nb de lieux variants en commun avec M1 :11

Lemme 	leçon
estoient	estoit (M1 N)	2
et por les granz torbes	et por le grant torbe (M1 N)	1
les torbes	la torbe (G1 M1 N)	1
s'asamblerent	s'asembla (G1 M1 N)	1
les flambes	la flambe (G1 N)	1
les flambes	le flamme (N)	1
descendoient	descendoit (N)	1
forces	force (G1 M1 N)	1
a eus	a lui (M1 N)	1
sa volenté	sa volenté de plusors afaires (M1 N)	1
formes	forme (G1 M1 N)	1
cez paroles	ceste parole (M1 N)	1
entendez	entende (M1 N)	1
les compaignies	la compaingnie (G1 N)	1

temps
51
Pourcentage : 2.5512756378189096
Nb de leçons en commun avec G1 :9
Nb de lieux variants en commun avec G1 :19

Nb de leçons en commun avec M1 :22
Nb de lieux variants en commun avec M1 :26

Lemme 	leçon
fu	estoit (N)	4
eüst	avoit (G1 M1 N)	2
ooient	oïrent (N)	2
ooit	oï (N)	2
eüst	est (N)	1
serve	servirai (N)	1
amonestast	amonesteroit (N)	1
feisoient	font (G1 N)	1
avoient	ont (G1 N)	1
seroit molt	fust molt (N)	1
estoit	avoit été (N)	1
avoient aoré	aoroient (G1 M1 N)	1
lessoient	lessierent (G1 M1 N)	1
avoit a lui envoiez	envoioit a lui (M1 N)	1
porent	pooient (M1 N)	1
pooient	puent (N)	1
devint	fu devenus (M1 N)	1
l'avoit grevé	l'agrevoit (N)	1
vout	voloit (C3 G1 M1 N)	1
avenoit	avenist (M1 N)	1
pleroit	pleüst (N)	1
oi	ai oï (N)	1
avenissent	fuscent avenues (N)	1
ooientoïrent soventes foiz	oïrent soventes fois et entendoient (N)	1
tesmoignoient	tesmoignent (M1 N)	1
devoit	doit (N)	1
erent receü	sunt chaü (N)	1
menti	mentoit (M1 N)	1
aporterent	aportoient (M1 N)	1
estoit de	est de (N)	1
voudroit	vielt (M1 N)	1
estoient	furent (N)	1
prooient	proierent (N)	1
poroit	pooit (N)	1
demenoient	demenerent (M1 N)	1
s'esleecierent	s'elleeçoient (N)	1
doit bien a vos soffire	vos doit bien souffire (M1 N)	1
et esleeciez	et si avés esté esleechié (M1 N)	1
fu en vie	ert en vie (N)	1
devroient	doivent (G1 N)	1
di	ai dit (M1 N)	1
entendoit	entendi (M1 N)	1
je	j'ai (M1 N)	1
m'esvellastes	m'avez esveillié (G1 M1 N)	1
estoit	avoit esté (N)	1



om.
477
Pourcentage : 23.861930965482742
Nb de leçons en commun avec G1 :179
Nb de lieux variants en commun avec G1 :203

Nb de leçons en commun avec M1 :243
Nb de lieux variants en commun avec M1 :258

Lemme 
et 	37
si	25
Et	15
il	15
i	11
de	11
li	10
a	8
se	7
grant	7
en	7
bien	7
molt	6
la	5
lor	5
mout	5
ce	4
tout	4
ne	4
meïsmes	4
les	3
tuit	3
je	3
ensamble	3
Jesu Crist	3
seinz	3
dist	2
adonc	2
seinte	2
fu	2
de ce	2
ja	2
a lui	2
sovent	2
Un autre miracle	2
seint	2
qe	2
fors	2
toz	2
par	2
qi	2
por	2
a hautes voiz	2
vous	2
devant	2
De .seint. Martin	1
et bone volenté	1
et par ce	1
l'amor	1
neet de ses gages	1
le jor	1
et besoigneus estoient	1
qe nul bien ne li firent	1
qui venoit derrieres	1
feïst bienaucun bien et 	1
n'autre rien	1
l'oevre de	1
de mesvoz enemis	1
qiqu'il ne voloitvolt mie	1
erranment	1
et seisi	1
est	1
nus	1
a seinte loyla sainte foi . et a la vraie creance del seintde baptesme	1
Seinz
                  Martins	1
le cors de	1
en croiz	1
aprés	1
dist et 	1
Adonc et 	1
qi en  la contree estoient	1
apelé	1
et li evesqe.	1
amor	1
eüe	1
lius	1
autre chose. ne	1
voie meïsmes	1
fet	1
et sa doctrine	1
avoient	1
einz	1
en nule maniere	1
et en  proieres	1
venue	1
lor deliz d'endroitaese de lor cors	1
com il	1
mon signeur	1
non	1
empriés	1
ceste seculer vie	1
et mout bien atornee	1
nene nene il n'i mist mie grant auctorité	1
qe ce vint a unau jor	1
priveement	1
li seinz hom	1
Si com seinz Martins resuscita un
              mort	1
l'en	1
et s'estut	1
de la contree	1
environenviron environentour les chans et 	1
cil q'il avoitavoient encontrez	1
qant il vout	1
tot	1
encore	1
a trenchier	1
pleinement	1
un pou loing	1
et esperdu	1
mes	1
et a preeschier	1
et lor proieres	1
de crestiens et autieus	1
Si com il ardi un templeun temple de paiens	1
estoient	1
la loy	1
mout durement	1
et granz merveilles	1
adonques	1
q'il	1
Si com il abati un temple	1
Et	1
li evesqes	1
et maumis	1
en tel maniere	1
environ li	1
a dire	1
en li	1
qi fust sipas dignes	1
les signes de	1
a crier	1
le seint home	1
et atendoient	1
Si com il delivra le serjant au conselle	1
en sa meson	1
as	1
et crioit	1
et si dist	1
meintenant	1
par bones exemples et 	1
Si com il chaça le deable hors d'une
              meson	1
 l'entree de	1
sa	1
tout ardant	1
Uns miracles de seint Martin	1
qui leur disoient (#C2)	1
et fors de doutance	1
Uns autres miracles	1
et ses oevres	1
encor	1
Uns autres miracles	1
en nule maniere	1
la grant	1
mondee de	1
cruele	1
par lui	1
Si com il rendi a un home son oel 	1
apelez	1
q'il i avoit	1
Si com il cheï del cenailldou cheval	1
Martins	1
si li	1
totes	1
et de dire	1
de Rome	1
de feire	1
genz	1
mie	1
ce estoit	1
fete	1
hauz	1
aussi	1
un jor	1
si com il est encore en us et en costume	1
a celui qi agenoilliez estoitestoit agenoilliés	1
BuerBien fu nés qi le bien puet feire	1
au prestre	1
et destruiz	1
et qi	1
si tost	1
tost	1
par	1
ne en nule forme	1
dea lor freres	1
par aventure	1
et ceste oevre	1
a la voie	1
li jous	1
as freres	1
oïr	1
vos	1
hom	1
ce est de ses deciples	1
une autre foiz par lui	1
ne ne devoit avoir de nostre Signor nule
                indulgense	1
digne	1
bone	1
freres	1
ensamble o lui	1
l'	1
en lui	1
aloient entre lui et Deu: et 	1
Quant AntiolusNatholius sot et entendi qe Clarus ne leli voloit croire	1
tres	1
i estoient oïez	1
Puis	1
d'une resplendissant porpre	1
et si dist	1
entre eus	1
lui meïsmes	1
veïmes	1
et de cler	1
estre	1
pas	1
einsi	1
fu si hardiz q'il	1
et aprés distsi dist	1
proprement	1
mes meins	1
nos	1
vilenie et 	1
li escondeïsse ne	1
en tot	1
le	1
beau	1
hors	1
qe, qant il se fu esveilliez	1
bon	1
adés	1
del cors	1
hastivement	1
mortel	1
nostre Signor	1
qe tu	1
si dist	1
a sosfrir	1
et faire	1
onqes	1
et en jeunes	1
ne ne presçoie	1
toz tens	1
aler a nostre Seignor	1
gloire	1
granz	1
qant li seinz hom fu mors	1
et une grant dissention	1
et doivent	1
tanten tant com il fu	1
envers nos	1
seinz hom	1
de grant maniere	1
grant	1
ne n'entendoitentendoit	1
et entendoit	1
et la joie	1
un pou	1
en lor compaignie	1
pecheors	1
Seinz
                  Sevrins li arcevesqes nota le tenstantost le tans et l'eure: q'il ceste chose avoit oïeavoit ceste chose oïe et puis si envoiaenvoia tantost a Tors un message tost et isnielement: por savoir se ceste
                chose estoit einsint avenue. QantEt quant li messages vint
                  a la cité de Tors, il enquist la chose par grant diligenseentente, si sot et entendi bien par les preudomes de la cité q'a cele hore tout droit. qecom seinz Sevrins l'arcevesqes de Coloigne ot lesle voiz oïes des angles, estoit seinz Martinset que saint Martin estoit trespassés de ceste mortel vie. 	1
meïsme	1
ou de .iii..iiii.	1
trestot	1
mout s'en esmervellierent, si	1
et l'eure	1
et la mere nostre Signor Jesu Cristma Dame sainte Mariela haute Dame me Dame sainte Marie qi roïne est de tote creature	1
Ci conmence la translation del corsmonseigneur seint Martin evesque	1
Ci conmence
                  la translation del cors seint
                    Martin Evesque. Aprés ce qe li seinz hommessires saint Martin dontde qui je vos ai contéconté et dit la vie fu trespassez de cest mortel
                  siecle .lxiiii. anz tout droitement fuAprés fu eslevezesleuz a archevesqes estre arcevesquesde Tors uns seinz hom. et de bone vie qi PerpetuusPropetuus estoit apelez par non. Qant il fu en la
                dignité et en la signorie, il porpensase porpenssa a fere sor le cors seint Martinde seint Martinmonseigneur saint Martin plus haute eglisse et plus bele. q'ele n'i estoit
                faite. Ce fist il par molt grant estude. et molt en aurions a parler conment
                  l'oevre fu parfaite et consomeeachevee, se nous a plus haute chose raconter
                  et dire: n'avions proposé a metre
                nostre entente. Qant ele fu toute parfete et consomee, li seinz archevesqes manda toz les voisins evesqesevesqes voisins et toz les abbés et les prestresprelas et les clers de la contree por l'eglisse dedier
                et beneïr et por le cors de saint Martin oster de la ou il estoit enfoïzde la ou il estoit enfouiz oster et metre en autre leu
                  a grant honeur,  aet a grant joie et a grant segnoriegranz seignories si com droiz estoit.  Et por cepour ce que voloit li bons archevesqesli bons evesques vouloit qe ceste translation fust fete le jor des premieres kalendes
                de juignetjuing. Il veillierent la nuit devant. et qant vint laa la matinee, il conmencierent a foïr la terre qi estoitest dit deseur le sarqusaint sarqueul, et puis si misent lorles meins tot entor por leverlaverpor lever tot entor le amont et por remuer leesmouvoir plus haut. Mes onqesainz ne sorentse sorent tant pener ne traveilliertravaillier ne esforcier q'il le peüssent removoir en nule maniere. DontAdonc furent molt dolenz et si lessierent trespasser le jor tresq'a la nuitjusques a la nuit qi venoit. Et cele meïsme nuit revellierent  iltravaillierent toute tresq'a la matineejusques a la matinee. DoncAdonc si ressaierentessaierent s'il poroient le seint cors atot le sarqu removoir nena amont treirelever ne remouvoir ne amont traire. LorsDont furent molt dolenztriste et molt espoentez, car il
                ne le pooient movoirremouvoir nen'il ne savoient q'il en peüssent
                fere. Dont parla uns des clers qide cels qi lailec estoient et si dist : DontEt ne savez vos, beausbeaubien signors, qe tresq'a tierz jordusques a tiers jour seraest la feste del jorle jour de la feste q'il reçut l'arcevesqiéle veschié, et ceste feste avoit il acostumé
                  a feire. ParEt par aventure tresq'a ce jordusques a cel jour. ne velt il c'on le remueve. Li evesqearchevesques et li clergiés qi la estoient assembleztuit li autre clergié: s'asistrents'asentirent a ces paroles, si i furent tresq'au tierz jorjusques au tiers en jeunes et en orisons et en vegiles.	1
Et qant vint au qarttierz jor, il s'aprochierents'aprochierent tuit au sarqu ou li corsli cors saint gisoit del seint home, si i mistrent toz les meins por removoir leesmouvoir et por lever lerelever, mes il ne porent. QuantEt quant il virent ce, siil furent toz espoentez: ne ne sorent q'il peüssent feire, et tant qu'il se porpenserent q'il recoverroient de terre la sepouture q'il avoient descoverte. Si comLa ou il estoient en cele doutance, uns vielz hom
                de mout grant beauté, aussi
                blans conme nois negie, s'aparut
                  a els. et il li
                demanderent qi ilq'il estoit: et il
                lor distrespondi q'il estoit uns abbes. et puis si parla et lor distleur dist tiex paroles : Por qoi atargiezacouchiez vos. et por qoi estes vos maladesdolent et tristre ? DontEt ne veez vous seint
                    Martin qi vos vient aidier. a ceste chose se voz i volez les meins metre ?  Dont
                osta li blans hom qi lailec estoit venuz s'afubleüresa vesteüre. et li prestretuit li prestre aussi qi la estoient et li vesqe, et les seintes reliqes et les croiz
                      et .vii. cierges i furent aportez tos ardanzqui avoit aportees les croiz et les saintes reliques et .vii. cierges ardans. Dont conmencierent l'anteveneune anthiene a chanter. et si leverent le sarqu del seint home en haut molt
                  legierement. par l'aïde del viel home, si l'emporterent et misent elen un leu ou il estoit aoreza esté  tresq'a hui cest jorjusques a ores. Et qant il fu mis et assis en son lieutornez et conreez a la volenté de l'evesqe qi Perpetuus avoit nondu saint archevesque qui propetuus estoit apelez. et la messe fu
                  chantee. et il se furent assamblé por mengier ensamble si com il estoit costume adonqes, il manderentdemanderent le viel home qi aidié lor avoit, mes il n'en troverent mie. ne il n'estoit la nus homn'i ot celui qi l'eüst veü issir de l'eglisse. 	1
Por ce croi jecrei je biencroi je veraiement qe ce fu aucuns angeles qi por le seint hom s'aparut ilueqess'apparut pour le saint home ilec voiant touz cels qui
                    y estoient, et sine ne s'aparut onqes puisplus a nul d'eus de cels de l'eglissequi en l'eglise estoient. Et en icelcest leu ou li cors del seint home fu mis avindrentvindrent tres ce jor en avant meint beau miracle. qi par negligence sont lessié en escripture a metrea metre en escripture. Mes nos en
                  avons conté et dit: ce qe nos en avons en nostre tens veüveïsmes en noz tans: et qeet ce que nos en oïmes conter par autruipar autres conter: et ce qe nos
                en deümesdevons veraiement croire. par l'aïde nostre
                  Signor. qi vit et regne par tos les siecles des sieclesdes siecles sanz fin. Amen.	1



Leçons d'ordre sémantique (1076)
Pourcentage : 53.82691345672836
Nb de leçons en commun avec G1 :261
Nb de lieux variants en commun avec G1 :533

Nb de leçons en commun avec M1 :577
Nb de lieux variants en commun avec M1 :722

Lemme 	Leçon
car	que (N)	13
Si	et si (M1 N)	13
ensamble o	avec (G1 M1 N)	13
au	a (N)	12
Si	il (N)	12
trestoz	si (G1 M1 N)	10
si	et (M1 N)	10
Lors	Dont (G1 M1 N)	10
del	de (C2 N)	9
de	pour (G1 N)	8
la	le (C2 C3 G1 M1 N)	8
entor	en (N)	7
cil qi	qu'il (G1 M1 N)	7
non	ne (M1 N)	7
si	li (N)	7
q'il i	qui (N)	5
ou	dist (N)	5
contre	encontre (N)	5
sa	la (N)	5
Si com	La ou (G1 M1 N)	5
envers	vers (M1 N)	4
li	et li (M1 N)	4
si com	la ou (G1 N)	4
l'avoit	avoit (M1 N)	4
prist	traist (N)	3
ert	estoit (M1 N)	3
en coi	dont (M1 N)	3
Adonc	Et dont (M1 N)	3
deguerpir	guerpir (C2 G1 M1 N)	3
et en abiten l'abit de moigne	ainz (G1 M1 N)	3
Si	Et (M1 N)	3
encontre	contre (G1 M1 N)	3
fors	hors (G1 M1 N)	3
ensamble o	ensamble (N)	3
ce	cose (N)	3
Mes	Car (N)	2
eve	aigue (N)	2
parvindrent	vindrent (G1 M1 N)	2
contree	terre (G1 M1 N)	2
departi	parti (N)	2
respondi	li respondi (G1 M1 N)	2
trespassé	passé (C2 C3 G1 M1 N)	2
nostre Signor	de Dieu (M1 N)	2
Li	Et li (M1 N)	2
seinz	saint home (G1 M1 N)	2
trestoz	touz (G1 M1 N)	2
lonc	grant (M1 N)	2
tens	piece (N)	2
creanz	creance (N)	2
mie	encore (M1 N)	2
tresq	dusqu'a (M1 N)	2
borjois	preudom (N)	2
trestuit	tuit (G1 M1 N)	2
d'une part d'	par (G1 M1 N)	2
et nient	nient (M1 N)	2
cuident	doivent (N)	2
la	illuec (N)	2
de son	du (G1 M1 N)	2
bien	riens (M1 N)	2
jusc'a	dusc'a (M1 N)	2
seinz Martins	li saint hom (G1 M1 N)	2
environ	entor (M1 N)	2
qe	com (N)	2
estoit	pooit estre (M1 N)	2
environ	entour (G1 M1 N)	2
covenoit	voloit (M1 N)	2
si com	quant (G1 N)	2
de	por (M1 N)	2
del	al (N)	2
de	des (C2 C3 M1 N)	2
dementieres	entrues (N)	2
pluisors	molt (N)	2
lui	saint Martin (N)	2
pou	petit (N)	2
conceles	provos (M1 N)	2
la	se (N)	2
ensamble lui	avec lui (M1 N)	2
ensamble o	a toute (G1 N)	2
fu	fu il (G1 M1 N)	2
pluiseurs	maintes (N)	2
hauz cuens	plusors (G1 M1 N)	2
Maximiens	Maximes (G1 M1 N)	2
les	ches (M1 N)	2
cel	tel (N)	2
en la compaignie au	avec le (G1 M1 N)	2
a l'anemi	au deable (G1 M1 N)	2
Meintenant	Et tantost (M1 N)	2
tresq'au	dusc'au (M1 N)	2
mout doit on  doucement et volentiers le bien oïr et entendre	Cascuns Crestiens doit bien etendre et volentiers oïr le bien (N)	1
par le  bien savoir et retenir	por le bien oïr et savoir et retenir (M1 N)	1
nest	vient (N)	1
sovent	adiés (N)	1
del	et de (N)	1
en totes lor vies	en tot lour vivant (N)	1
petit avoir fait	petit de bien fait (N)	1
richesces et avoirs	avoir (N)	1
desirrent	covoitent (N)	1
deables	anemi (M1 N)	1
et pris	et loiés (M1 N)	1
q'il les enmeine	qui les enmeine (C3 G1 M1 N)	1
gardent	garderent bien (M1 N)	1
tormenz	martires (M1 N)	1
A ce regarderent	a ce pristrent garde (G1 M1 N)	1
confessors	home confes (N)	1
dont ci comence la vie	dont jou commencerai la vie (N)	1
de la contree de Pannone	de la contree de Ponnone (N)	1
Ysabbarie	Ysapharie (G1 M1 N)	1
s'enfance	enfance (N)	1
covoita molt	conmença (G1 N)	1
l'en detint et retraist	le detint et fist atargier (M1 N)	1
en sa pensee	en pensé (G1 N)	1
docement	devotement (M1 N)	1
enfanz avoient: chevaliers les
                feïssent.	avoient les enfans les fesiscent chevaliers (N)	1
si douz	a la court si dous (N)	1
ne nule folie	de nule felonie (M1 N)	1
. et douçour. et pitié. et 	dolece et piue et (N)	1
l'umanité	l'umilité humainne (M1 N)	1
si ert il si douz et si pius	si ert il dolz et pius (C3 M1 N)	1
resembloit	sambloit (G1 M1 N)	1
signorie et reverence	amor et seignorie (M1 N)	1
si	ensi (N)	1
ne por qant	et ensivoit (G1 M1 N)	1
cels	tous chiaus (M1 N)	1
soffroient	faisoient (N)	1
chetis	cartriers (N)	1
revestoit	vestoit (G1 M1 N)	1
mestier	soffraite et besoigne (N)	1
lendemein	sen demain (N)	1
q'il chevauchierent un jor par la citéchevauchoient par la cité un jourchevalcherent par mi la cité un jor	un jour qu'il trespassa par mi la cité (N)	1
povre 	molt povre (G1 M1 N)	1
a proieret a proier et a rover	a rover et a proier (N)	1
lui passoient	le povre passoient (N)	1
n'avoient fait au povre home nul
                bien	ne li faisoient nul bien (N)	1
donast	li donast (N)	1
aucune chose	del sien por s'amor aucune cose (M1 N)	1
granz	si grande (N)	1
son mantel par mi	le moitié de son mantel (N)	1
moitié	partie (M1 N)	1
partie	moitié (M1 N)	1
Dont	Lors (N)	1
le conmencierent a escharnir	le conmencherent a gaber et a escarnir (M1 N)	1
pluiseur	auquant (M1 N)	1
onqes n'avoient	n'avoient mie (N)	1
avoir fait	faire (M1 N)	1
beneoiz	bons (M1 N)	1
regardast et coneüst	reconneüst (M1 N)	1
il	il meïsme (M1 N)	1
devant dite	dite avant (M1 N)	1
baptiziez	crestienés (N)	1
en cui compaignie il estoit venuz	avec qui il estoit venus en conpaignie (G1 M1 N)	1
Endementieres	Entre ces choses (G1 M1 N)	1
la terre	la contree (M1 N)	1
destruire	gaster (N)	1
estoit costume	estoient acostumé (N)	1
tant	et tant (N)	1
Ne	et ne (N)	1
droiture	drois (M1 N)	1
tresc'a	jusque (G1 N)	1
sueffre	soies seürs (N)	1
soie	voldrai estre (N)	1
nostre Signeur Deu	notre signor (N)	1
dons	deniers (M1 N)	1
de corroz et d'ire	tous de maltalent (N)	1
molt hardiement seinz Martins	sains Martins sans doutance et sans paor (M1 N)	1
ma	ta (G1 M1 N)	1
serai	si serrai (N)	1
por ce	pour ce qu'il vouloit (G1 M1 N)	1
alast desarmez ena la bataille	n'alast a la bataille tos desarmés se ele eüst esté (M1 N)	1
il vout qe la pes fust ensi faite	ja soit che cose que le pais fust ainssi faite par se volenté (M1 N)	1
seinz Martins	mesire sains Martins (M1 N)	1
seinte	boine (N)	1
en avisionune vision unecele nuit	une nuit en volenté (N)	1
Et	Mais (M1 N)	1
il entresait s'en iroit	que otroier li convenoit (M1 N)	1
deguerpissoit	se partoit de (M1 N)	1
de diversitez	d'aversitez (G1 M1 N)	1
gaitoient	agaitoient (G1 M1 N)	1
vindrent	parvindrent (M1 N)	1
vout	cuida (N)	1
prist	aert (M1 N)	1
comanderent	carquerent (M1 N)	1
liu trestorné	liu destolu (M1 N)	1
ensus	loing (M1 N)	1
heitiement	hardiement (N)	1
socoroit	suivroit (N)	1
fiance	nule fiance (N)	1
crut	fu convertis et crei (M1 N)	1
Aprés	Et aprés (G1 M1 N)	1
tote sa voie	tout son chemin (G1 M1 N)	1
son chemin	mi sa voie (G1 M1 N)	1
Seinz Martins	Et sains Martins (N)	1
dist	respondi (M1 N)	1
ou	qe (G1 N)	1
toz tens	touz jourz (G1 N)	1
dist	li dist (N)	1
deables	anemis (M1 N)	1
sauvement	le salveté (N)	1
secce	saiete (N)	1
il	li sains hom (M1 N)	1
q' il avoit	qui avoit (G1 N)	1
s'en revint adonc	Lors s'en revint messires sains Martins (M1 N)	1
arrester	habiter (N)	1
entor	illuec avec (N)	1
annoncier	a Engiers anuncier (N)	1
fermement	en ferme (N)	1
vint	ce vint (N)	1
si ert soudainement morz	et si estoit si soudainnement mors (M1 N)	1
estoit	si estoit (N)	1
environ	tout entour (G1 M1 N)	1
riule	le riule (M1 N)	1
nostre	de nostre (G1 M1 N)	1
seint	beneoit (M1 N)	1
la dedenz	laiens (G1 M1 N)	1
se movoient	li movoient (M1 N)	1
defors	par dehors (M1 N)	1
avoient lessié n'avoit se pou non devantde tens sans vie	avoient orendroit laissié sans vie mort (N)	1
rot	ot (C2 C3 G1 M1 N)	1
premerains	premiers (M1 N)	1
grant noise de plor et de cri	grant plour et grant noise (M1 N)	1
de pleinte	de plainte et de dolour (N)	1
si estoit	s'estoit (C2 C3 G1 M1 N)	1
un laz	une corde (N)	1
d'unedu corde	d'un lac (N)	1
et tolue la vie	courant (M1 N)	1
issir toz cels qi en l'ostel estoient hors	issir hors de l'ostel tous caus qi i estoient (N)	1
avoit esté	gisoit (M1 N)	1
au porche	le porte (M1 N)	1
Rurtius	Ratticius (M1 N)	1
avoit non	avoit a non (C2 M1 N)	1
qi a sa feme iert prise	qui tenoit se feme (M1 N)	1
por	d' (M1 N)	1
venir	aler (G1 M1 N)	1
de Tors tant seulement	de la tant seulement (M1 N)	1
de l'eveschié	des evesques (M1 N)	1
trop laidement	vilment (M1 N)	1
vileinement	laidement (G1 M1 N)	1
de povre persone	povre persone avoit en lui (M1 N)	1
nostre Sires	Dex (M1 N)	1
meint	tant (M1 N)	1
il l'eveschié	le seignorie del evesquié en abit de moine (M1 N)	1
venoient	venoient qu'il ne le pooit souffrir en nule maniere (N)	1
vousist	desirroit (G1 M1 N)	1
avoir	a avoir (M1 N)	1
de l'autre	d'autre (M1 N)	1
plaigne	planete (N)	1
deciple	si desciple (G1 M1 N)	1
fetes lor maisonceles	faisoient lor maisons (N)	1
habitations	habitacles (N)	1
freres	desciples (G1 M1 N)	1
nus	nus d'iaus (M1 N)	1
estoient en communité mises totes lor choses	toutes lor coses erent en communité mises (N)	1
fors seulement d'enescritures	fors tant seulement des escritures (M1 N)	1
ancien	viel (N)	1
conmant	conmandement (M1 N)	1
et si erent	li ancien estoient (G1 M1 N)	1
nus	d'els (C3 G1 N)	1
Tuit manoient ensamble	Tout ensamble mengoient (M1 N)	1
avoit	avoit onques (N)	1
poil	soies (C3 M1 N)	1
por plus (#C2 #C3 #M1)	plus (C1 G1 N)	1
avoit ensamble o eus	entreuls avoit (G1 M1 N)	1
molt eüssentfeïssent bien al siecle lor volentez	mout bien eüscent al siecle lour volentés et lour aaises de lor cors
                acomplies (N)	1
conqerre	aquerre (N)	1
pluiseur	auqant (M1 N)	1
des	d'eus (C2 M1 N)	1
covoitast	couvoitast u desirast (N)	1
evesqe	a evesque (N)	1
tel	cel (N)	1
s'a	fors a (N)	1
veoir	sovent veïr (N)	1
le dïent	di je (M1 N)	1
finir	morir (M1 N)	1
en cest siecle le travail	travail en cest siecle (N)	1
de seint Martin	de mon segneur saint Martin (M1 N)	1
pasteur	mestre (G1 M1 N)	1
Si	ou (G1 M1 N)	1
veü meintes foiz	souventes fois veü (M1 N)	1
une eglyse	l'eglise (M1 N)	1
onques	ains (N)	1
creature reson	certaineté (G1 M1 N)	1
seüst fere	seüst enquerre (N)	1
entendi	oï (N)	1
n'ert	n'avoit (N)	1
mie	entendu (N)	1
certeins	seurement (M1 N)	1
o lui	atout (G1 N)	1
gisoit	estoit enfouis (N)	1
merite	merite il estoit (N)	1
jouste	delés (M1 N)	1
lez et hisdeus et cruel	lait, noir et cruel (N)	1
conmanda	demanda celui (N)	1
et ensamble o	et avec (M1 N)	1
celui parler	çou que cil disoit (N)	1
qi ensamble o lui estoient	devant lui estoient (N)	1
cele fole	fole (M1 N)	1
cele malvese	malvaise (M1 N)	1
aloit	s'en aloit (M1 N)	1
portoit	enportoit (N)	1
de loing qi venoit	que de loins venir (N)	1
se fu arrestez	ot alé (M1 N)	1
tant	l'espasse (N)	1
avoir	estre (N)	1
aperçut	perchut (M1 N)	1
cuida	quida et crut (G1 M1 N)	1
costume	acoustumanche (M1 N)	1
soloient	la souloient (G1 M1 N)	1
France	cel païs (N)	1
comportoient	portoient (G1 M1 N)	1
Por	Et par (N)	1
feïssent	fuscent (N)	1
fist	fist il (M1 N)	1
a terre	jus (N)	1
s'arresterent	arresterent (N)	1
a terre	jus a terre (G1 M1 N)	1
aussint com	et furent (M1 N)	1
Et don	Et lors (N)	1
a esgarder	a regarder (N)	1
se porpensoient	a penser (N)	1
esmervelloient	s'esmerveilloient (N)	1
Ensement	Ainsi (M1 N)	1
vertu	le volenté et par le vertu (M1 N)	1
li hom	li seinz hom (C3 G1 M1 N)	1
et de gent sarrazine	des gens sarrasines (N)	1
comença	conmença a trancier (N)	1
q'il nel trenchast nenane n' abatist	a trancier et a abatre (N)	1
par la volenté de Deu le temple aidié a destruire	souffert par le volenté de Dieu le temple a despechier (M1 N)	1
en tel maniere	ainssi (M1 N)	1
devoit	le devoit (M1 N)	1
des plus  hardiz	qui plus hardis estoit (M1 N)	1
l'oses	le veus (N)	1
vendra trebuchant	venrra trebuschant de grant ravine (M1 N)	1
oï	lor oï (N)	1
en tel liu estoit	en cel liu estoit (M1 N)	1
rieng	nule rien (N)	1
clinoit plus et pendoit	se clinoit et plus pendoit (N)	1
lor arbre a trenchier mout liement. et a grant joie por abatre	par grant amor et par grant joie lour arbre detrencier et abatre (N)	1
comencierent	prisent (M1 N)	1
escroller	crouller (M1 N)	1
avoient	en avoient (M1 N)	1
doutance	doute (G1 M1 N)	1
a venir envers  lui et a cheïr	a caïr vers lui et a caïr (N)	1
estoit granz et pesanz	molt pesoit (M1 N)	1
et de nule rien n'ert sostenue	ne n'iert de nule part soustenus (M1 N)	1
tant pesoit	de grant pesantume estoit (N)	1
pou	un poi (G1 M1 N)	1
el plus seür	en pluseurs (G1 N)	1
se tornerent	s'atornerent (G1 M1 N)	1
fole	mauveses (G1 N)	1
creance	esror (M1 N)	1
seürement	certainement (N)	1
cele	toute cele (N)	1
granz	boines (N)	1
Et en cel leu ou	Et la ou (G1 M1 N)	1
molt ancien	anchien (M1 N)	1
un leu	une voie (G1 M1 N)	1
creoient	creoient mie (M1 N)	1
a plein: et la chaleur desmesureea desmesure	a force et a desmesure (N)	1
a demener	a mener (M1 N)	1
gardoit	garantiscoit (N)	1
tost	molt tost (M1 N)	1
esprise	arse (M1 N)	1
errant	errament (C2 G1 M1 N)	1
pleinement	plenierement (N)	1
peüssiez	ne peüsciés vous (N)	1
de la	d'ilec (G1 N)	1
jeunes	juner (N)	1
Si prioit	Et si prooit (M1 N)	1
celtel temple depecier par sa force	cel temple a forche pechoier (M1 N)	1
Dont	Adont (M1 N)	1
escuz	et escuz (G1 M1 N)	1
chevaus	destriers (M1 N)	1
richement coverz de molt beles covertures	de molt bele faiture (M1 N)	1
desconfeïssent	les desconfesissent (M1 N)	1
depecheroit	deperoit (N)	1
la emplist	l'empreist (M1 N)	1
avoit	l'avoit (N)	1
si debrisa et destruist	si l'abati et debrisa (M1 N)	1
tresqe el fondement	dusc'au fondement (M1 N)	1
tuit li paien	li assamblee des paiens (M1 N)	1
conterai	dirai (N)	1
en us et en costume	a us et a coustume (M1 N)	1
mout de vileinz	une grant torbe de vilains (G1 M1 N)	1
se fist hardi	hardi estoit (M1 N)	1
de toz les autres	des autres (N)	1
encontre	arriere (G1 M1 N)	1
mes il abandona	se li abandona (N)	1
ferir	ferir sus (N)	1
doute	doltance (N)	1
evesqe	home (C2 N)	1
coup	espee (M1 N)	1
q'a poi	si durement qu'a poi (M1 N)	1
pardon	merchi et pardoin (N)	1
Cis	Li (M1 N)	1
miracles qi aprés cestui vientvint	que jou conterai (N)	1
a depecier	a combrisier (M1 N)	1
a destruire	a confondre (M1 N)	1
por lui ferir d'un coutre
                et ocirre	atout un coltre pour lui ferir et ochirre (M1 N)	1
tuer le seint home	pour ferir le saint homme (N)	1
s'esvanui	s'enfui (N)	1
destruire et depecier	confondre et destruire (N)	1
tieus poissance	si grant poiscance (N)	1
estoit en lui	avoit il (M1 N)	1
enfermetez	enferté (N)	1
et curer	par le volenté de nostre Seigneur (M1 N)	1
tuit cil qui  a lui venoient i recevoient
                santé	nus malades ne venoit a lui qui n'eüst mout tost santé recoiuvree (N)	1
palezins avoit	d'enferté de palasine estoit (N)	1
sorprise	si souprise (N)	1
enfermeté	maladie (M1 N)	1
proisme	ami (M1 N)	1
gardoient	atendoient (M1 N)	1
en tel point	en tele maniere (M1 N)	1
molt sovent	et avoit faites (M1 N)	1
aavec lui venoients'assembloient	se tenoient a lui (N)	1
retenir et entendre	entendre et retenir (N)	1
par dolereus martyre muert et perist en langor	muert par dolereuse maniere de langueur (M1 N)	1
ait ele	retiegne ele (M1 N)	1
si	et que tu (M1 N)	1
Au daerrenier	En le fin (M1 N)	1
s'arresterent fors de la porte	dehors le porte arresterent (M1 N)	1
li serz nostre Signor	li ber nostre Seignour (N)	1
conmanda	rouva (M1 N)	1
leva	leva tantost (N)	1
de s'enfermeté et curee	de s'enferté et reçut santé (N)	1
tiesmoigne	li evesque le tesmoignent (N)	1
avoit non	estoit apelez (M1 N)	1
cels	les gens (N)	1
denz	dens eskignes (M1 N)	1
li conceles	li prevos (M1 N)	1
en	a le (N)	1
d'escomenié	del escumeniier (N)	1
encovença	ot en couvent (G1 M1 N)	1
de celui	del cors de chelui (M1 N)	1
le serjant	le vallet (M1 N)	1
toz tens aprés	tous jors puis cel di (N)	1
vint li seinz hom	quant le sains hom vint (M1 N)	1
se departisist de la et 	se partesist de la et (N)	1
se	s'en (G1 N)	1
de la	d'illuec (N)	1
enemis	deables (G1 M1 N)	1
estoit entrez el cors	avoit saisi et pris (N)	1
meson	mesnie (G1 M1 N)	1
sanz poor	sans paour avoir (M1 N)	1
se tenist	fust (G1 M1 N)	1
seint home	preudomme (N)	1
qe se ce fust	com il fesist (N)	1
vit	si vit (N)	1
la dedenz	laienz (G1 M1 N)	1
et ne qe dent	toutevoies (M1 N)	1
cremeur	cremance (M1 N)	1
del cors	fors (N)	1
derriers	dessous (M1 N)	1
de ce fu il mout dolenz	ce fist il molt dolanz (G1 M1 N)	1
choses	oevres et ches coses (M1 N)	1
conmanda	demanda (M1 N)	1
dist	jehi (N)	1
poor	errour (N)	1
doute	doutance (C2 N)	1
creance	errance (G1 M1 N)	1
de l'enemi	del deable (G1 M1 N)	1
affermez en la seinte creance	en ferme creance ne en vraie (G1 N)	1
Mes qant il	Quant il (M1 N)	1
pres que tote et 	et pres tout (N)	1
Qant	Et quant (M1 N)	1
beneï	le beneï (N)	1
il fu	si il (N)	1
graces	graces et loenges (N)	1
la santé q'il avoit receüe	chou qu'il avoit santé recheüe (M1 N)	1
la vie	de la vie (M1 N)	1
avoit non	estoit apelés par non (M1 N)	1
Si	Cil (G1 M1 N)	1
tres cruieus	dolerouse (N)	1
n'en cuidoit	ne quidoit (M1 N)	1
coment	pour quel maniere (G1 M1 N)	1
disoient	devisoient (N)	1
maladie	fievre (N)	1
la poitrine	le piz (G1 M1 N)	1
pucele	damoiseles (G1 N)	1
qi la destreignoit	fors de son cors et ensus de li cachie (M1 N)	1
sa fille	la damoisele (G1 M1 N)	1
par la volenté	par par humilité et par le volenté (N)	1
au a un home son
                oel seint home	a li (G1 M1 N)	1
rien	goute (G1 M1 N)	1
toucha	acolça (N)	1
son oel	a son oel (M1 N)	1
molt	grant pieça (N)	1
lonc tens avoit portee	avoit lonc tans eüe (G1 M1 N)	1
brisierent	froiscierent (N)	1
contreval	qu'il fist contreval (G1 M1 N)	1
mout	tous (M1 N)	1
plus	le plus (N)	1
del chaïement	de keüre (N)	1
raconter	conter (M1 N)	1
puis	pour ce (G1 M1 N)	1
blandissoient	blasmoient (M1 N)	1
les apostres	le maniere des apostres (M1 N)	1
roi	rois de France (N)	1
et 	mes (G1 M1 N)	1
ne li	nel (N)	1
hauz homes	gens (N)	1
Qant	Et qant (M1 N)	1
del empire	ne l'empire (G1 M1 N)	1
chevalier	baron (N)	1
la besoigne	le soig (N)	1
l'avoitavoient	et par sa vie l'avoit (N)	1
en	envers (G1 M1 N)	1
grant	bone (M1 N)	1
nul home	nului (N)	1
la pleniere bataille	pleniere bataille (G1 M1 N)	1
ensamble o lui mengeroit	mengeroit avec lui (G1 M1 N)	1
si grant joie l'en crut	a grant joie (N)	1
qe meintenant manda il	manda il maintenant le saint home. Il manda (M1 N)	1
d'une	une (N)	1
joste	s'assist dalés (N)	1
homes	contes (M1 N)	1
longuement	grant piece (G1 M1 N)	1
premier	primerain (C2 C3 M1 N)	1
pluiseurs	ne sai qans (G1 M1 N)	1
s'agenoilla	conme coustume estoit s'agenolla (M1 N)	1
Li empereres	Et li empereres (M1 N)	1
coumanda	li commanda (N)	1
beü	le coupe recheüe (M1 N)	1
si	et puis (M1 N)	1
bailla la coupe	le bailla (G1 M1 N)	1
venuz ertestoit venuz en sa compaignie	et qui illuec estoit venus avec lui en compaignie (N)	1
la dedenz seoient	la estoient (N)	1
chascuns	on (M1 N)	1
de haute lignie et acompliz de grant richescede haute seignorie et riches	de haute seignorie et de noble lignie et acomblés de grant
                richoise (M1 N)	1
Averont	auront (C2 C3 M1 N)	1
joie	tel joie (C2 M1 N)	1
Tel signorie et tel hautesce	et si grant bien et si grant haultece (N)	1
sauroit	porroit (M1 N)	1
Ja tant ne s'en entremetroit (#C2)	Chertes bon porçachier feroit (M1 N)	1
la venir ne pense	parvenir n'i pense (M1 N)	1
Est	il est (N)	1
certes	entrés (M1 N)	1
doit nestresieut venir li biens	seut li biens venir (N)	1
as ancïens	ne puet fallir (N)	1
environavec lui estoient	al mangier estoient (N)	1
combatre	abatre (N)	1
seüst	che seüst il (M1 N)	1
Valentinien	la Valentinien (N)	1
le	et le (N)	1
raconte	dist et raconte (M1 N)	1
onques	onques si tost (G1 M1 N)	1
asembla	asailli (N)	1
com	tantost com (N)	1
trespassa	passa (G1 M1 N)	1
meintes choses	molt de coses (M1 N)	1
muer	mucier (N)	1
tout plenierement	tout apertement (M1 N)	1
ja tant	ja (G1 M1 N)	1
ne s'i seüst atapir	si ne se seüst gaitier (N)	1
la celle au seint home	sa ciaulle (G1 N)	1
boidissant	bruiant (G1 M1 N)	1
ensanglenté	ainssi ensanglenté (M1 N)	1
reconta	aconta (N)	1
Et puis	Et puis si (M1 N)	1
nul	aucun (N)	1
venue	avenue (N)	1
Il	Chil (M1 N)	1
nus	nus moines (G1 M1 N)	1
defailloit	failloit (C2 M1 N)	1
noncierent	conterent (M1 N)	1
une partie d'els aler encontre	que li une partie d'aux l'alast querre (N)	1
li auqant	li plusour (M1 N)	1
il	mais (N)	1
pas mout loing alé	mie alé granment (N)	1
q'a pou	que pour un peu (N)	1
pres de morir	pres de la mort (N)	1
desjoins del jou	de son liu iscus (N)	1
einsi parlé	cou dit et tex paroles racontees (N)	1
devant	dit et (N)	1
devant ce qe	ainz que (G1 N)	1
devant ce	ançois (N)	1
meüssent	alascent (N)	1
celui qerre	querre celui (N)	1
s'entremetoit	se melloit (M1 N)	1
se tresmuoit il et aparoit	se mostroit il et aparoit (M1 N)	1
Minerve	Mihve (N)	1
q'il	si qu'il (N)	1
il	li deales (M1 N)	1
disoit erent males	li disoit a haute vois estoient malvaises (M1 N)	1
se movoit il mie dedenz son cuer ne ne trestornoit	s'en esmovoit li dedant son cuer ne ne mostroit nul samblant (N)	1
pluisors	par maintes (N)	1
estoient	estoient par lui (M1 N)	1
reconvertiz	converti (N)	1
recomençoit	conmençoit (G1 M1 N)	1
malveses	males (G1 M1 N)	1
deça en arriere	d'arriere (M1 N)	1
purgier	espurgier (G1 N)	1
devoit	les doit (N)	1
dont	u (N)	1
erent	orent (N)	1
devant issu	devant esté (N)	1
tieus	ces (M1 N)	1
males	mauvaises (N)	1
qe tu t'en repentisses	et tu te repentoies (M1 N)	1
par lui pardon	par lui merchi (N)	1
seinz hom	prodom (M1 N)	1
poez	poés vous (N)	1
ne	et sans (N)	1
apelez	apelez par non (G1 M1 N)	1
receü	ja recheüe (N)	1
novelement	n'avoit gaires lonc tans (N)	1
lessa quanq'il avoit	il deguerpi toutes ses coses terrienes (N)	1
doctrine	proiere (N)	1
grant	haute (G1 N)	1
loing	pres (N)	1
evesqe	hom (N)	1
Pluisors	Et plusor (M1 N)	1
servir	ensivir (N)	1
avoient	avoient mis (G1 M1 N)	1
Anatolius	Natholius (M1 N)	1
estoit apelez	avoit non (N)	1
pleinement	du tout (G1 M1 N)	1
Li jovenceaus	Clarus li prestres (M1 N)	1
demora	si demora (M1 N)	1
la	ilec (G1 M1 N)	1
par ce il	par ce qu'il (C2 C3 G1 M1 N)	1
de bone loy et de seinte vie	de boine creance et de sainte vie (N)	1
seinz hom	prodons (M1 N)	1
ne pot onques estre menez a ce	ne peüt onques a ce estre menés (M1 N)	1
icez	itex (M1 N)	1
et tramise	et deschendue (M1 N)	1
entendre	atendre (N)	1
la celle	li lieus (M1 N)	1
meintes	plusieurs (G1 M1 N)	1
c'on i veoit	qui venues i estoient (N)	1
murmures	pluisours murmurs (N)	1
voiz	coses (N)	1
s'abitation	sen habitacle (M1 N)	1
acorut	corut (N)	1
molt blanche	de grant dolçor (N)	1
savoir ne	ne savoit (N)	1
si c'on	si com (C2 M1 N)	1
demoustrast	moustrast (N)	1
tresc'a	jusqu'a (N)	1
ne qe dent	toutes heures (M1 N)	1
Clarus	frere Clarus (N)	1
tout premiers	tout li premiers (N)	1
amenerent	menerent (G1 N)	1
n'osoit	n'osoit mie (G1 M1 N)	1
mostrer devant lui	devant lui moustrer (M1 N)	1
q'il ne se pooit envers lui
                covrir por pooir qu'il eüst	qe encontre lui ne se pooit il couvrir de nule cose (M1 N)	1
recomencierent	conmencierent (G1 M1 N)	1
li pluisor	li pluisour des freres (N)	1
entremis	meslez (G1 M1 N)	1
venuz	avenus (M1 N)	1
ce	celui (N)	1
leva	se leva (N)	1
ot	l'ot (C3 N)	1
croire	acroire (N)	1
par lor folies	par le païs (M1 N)	1
dist	lor dist (M1 N)	1
conme	si conme (M1 N)	1
de	hors de (G1 M1 N)	1
tempoire	tans (N)	1
avint	vint (N)	1
chaucemente	chevalceüre (N)	1
il	i (C3 N)	1
premiers	premereins (C2 C3 M1 N)	1
mie	mie encore (N)	1
et corone	et coronne d'or (M1 N)	1
cez	toutes les (G1 M1 N)	1
toz	trestout (N)	1
oï je	oï jou bien (N)	1
Por	Et por (G1 M1 N)	1
meintes	pluseurs (G1 M1 N)	1
il estoit	c'estoit (G1 M1 N)	1
vertus	grans vertus (M1 N)	1
raconterai	conterai (G1 N)	1
a	avec lui a (N)	1
son seint mengier	se table (M1 N)	1
ja (#C3)	ije (C1 C2 G1 M1 N)	1
chose	çou (G1 M1 N)	1
les vices	le vie (N)	1
siecle	monde (G1 M1 N)	1
aparellierent	assisent (N)	1
en un secré leu	un serjant loing (N)	1
firent il	si firent (M1 N)	1
de fuere	d'estrain (M1 N)	1
lumiere	fumiere (N)	1
apris n'acostumé	a us n'a coustume (M1 N)	1
por	Et pour (G1 M1 N)	1
tele molece	tel moleche et si soef (M1 N)	1
le fuerre	l'estrain (M1 N)	1
deseur	seur (M1 N)	1
esprist el fuerre	prist en l'estrain (G1 M1 N)	1
l'agaitoit et destraignoit	le gaitoit et destraignoit  (M1 N)	1
qi estoit clos et serrez	dont li huis estoit fermés et clos (N)	1
fu reporpensés	se fu porpenssez (G1 N)	1
en fuieforce q'il peüstpoist feire	qu'il le peüst faire (N)	1
signum crucis	le signe de le sainte crois (M1 N)	1
se coucha	s'estendi (N)	1
envers nostre Signor Jesu Crist	a Dieu (N)	1
Tantost	Et maintenant (M1 N)	1
grever	grevanche (M1 N)	1
defors	dehors (G1 M1 N)	1
le feu	les flammes (N)	1
et si	et il (N)	1
Dex	nostre Sire (G1 M1 N)	1
en plorant	tout en plourant (M1 N)	1
orissons	vraies orisons (N)	1
fin	parfin (C2 C3 G1 N)	1
roses	rousees (C2 C3 N)	1
descendissent	descendiscendicent (N)	1
qui c'onqes	que qui onques (G1 M1 N)	1
temptés	tentés en tel maniere (N)	1
en	et en (N)	1
oïr	savoir (N)	1
defina	fina (G1 N)	1
deci	des ichi (N)	1
grant piece le tens	grant piece devant (G1 N)	1
lonc tens	longuement (G1 M1 N)	1
feire la pes	faire pais (M1 N)	1
neqe dent	toutes voies (G1 M1 N)	1
l'assomement	assomemens (M1 N)	1
ainz	ainçois (G1 M1 N)	1
la	sa (N)	1
aloient	s'en aloient (G1 M1 N)	1
dejoste	selonc (M1 N)	1
vit	vinrent (N)	1
sivoient. et chaçoient	sovent ençaçoient (N)	1
poez	poés vos (M1 N)	1
qi	li diales (M1 N)	1
guetent	agaite adés (M1 N)	1
noient. ne sont	ne sont mie (N)	1
ne	et qui (M1 N)	1
prendent	preïscent (N)	1
deguerpesissent	guerpesiscent (N)	1
desertesdiverses regions	desers la (N)	1
repoez	poez (G1 M1 N)	1
oïr	veoir (N)	1
par	partout (M1 N)	1
autel	autretel (M1 N)	1
ensamble	en une torbe (M1 N)	1
qi ce virent	qui courrirent (N)	1
seint Martin	lui (M1 N)	1
oiseaus	les oisiaus (M1 N)	1
Aprés	Après ce (C3 G1 M1 N)	1
el	au (G1 M1 N)	1
meintenant	tantost (G1 M1 N)	1
grant duel a demener	demenerent grant duel (N)	1
et se	si se (M1 N)	1
mie	mie a toi (M1 N)	1
tens	jors (M1 N)	1
ceus	de ciaus (M1 N)	1
voloit	se vouloit (M1 N)	1
desevrez	descheüs (N)	1
del	de tel (N)	1
delde tel travail sosfrir n'estoit mie
                veincuz	de tel travail n'estoit mie vencus pour travail souffrir (N)	1
aussint	doltans (M1 N)	1
doutoit	redoutoit (M1 N)	1
aemplir	acomplir (G1 N)	1
orisons	jenous (N)	1
s'en	se sour (N)	1
Et	Quant (N)	1
un pou de vil fuerre desoz lui metre	dessous lui metre un peu de vil estrain (M1 N)	1
s'alaschoit	lasquoit (N)	1
torner	retorner (M1 N)	1
fil	frere (G1 M1 N)	1
einçois esgarder le ciel	regarder le ciel ains (N)	1
s'en ira	en ira (N)	1
dejoste soi	entour lui (N)	1
aperceü	percheü (M1 N)	1
cruel	crueuse (G1 M1 N)	1
hastivement	sans demoranche (M1 N)	1
lumiere	lumiere terrienne (M1 N)	1
mostroit	le moustroit (N)	1
qi	qui li (N)	1
venir	avenir (G1 N)	1
estoient venuz et assamblez	y estoient assemblé (G1 M1 N)	1
oïrent	aouroient (N)	1
les voiz del ciel	le vois del ciel et les angeles (M1 N)	1
ceste vie	cest siecle (N)	1
premiers	premierement (N)	1
maladir	mauder (N)	1
la chosedevant vous est devant retraiteconté	jou vous ai conté devant (N)	1
ces	tiex (G1 M1 N)	1
monde	siecle (N)	1
cez choses qi sont petites	ces autres coses ester qi sunt petites (N)	1
certeine	certe (C3 N)	1
dementieres q'il	tan com il (M1 N)	1
qe ce	puis (M1 N)	1
dementieres	en dementiers (N)	1
est gardee	esgarde que (N)	1
sachiez qe	l'auque (N)	1
veve	vuidie (N)	1
l'eure de mienuit vint	la nuit fu venue (G1 M1 N)	1
d'environ	environ (N)	1
aval	contreval (G1 M1 N)	1
a grant joie	a grant ijoie et a grant leeche (M1 N)	1
a grant joie	a grant ijoie et a grant leeche (M1 N)	1
tres aprés	dusc'a prés (N)	1
Gracien	Gacien (C2 C3 N)	1
devoient	veoient (N)	1
l'oceïssent	les occesiscent (N)	1
de paine et de doleur	de dolours et de paines (N)	1
de ceste vie	de ceste mortel vie (N)	1
nombre	conte (M1 N)	1
trestot	tot (C3 M1 N)	1
assegure	en asseüre (N)	1
Tout ausi	tot si (N)	1
Sevrins	Severius (C3 M1 N)	1
El	De (N)	1
qi molt bien l'a fete	en romans bien faite (N)	1
leüe	seüe (N)	1
seint Martin	a saint Martin (M1 N)	1
li seinz hom	sains Martins (N)	1
le cuer de l'eglyse	le moustier (N)	1
droit	tout droit (M1 N)	1
chanterchantanteschantans en l'air	en l'air cantant (M1 N)	1
grant joie et de grant esleecement	de joie et de leece grant (N)	1
oïr	entendre (N)	1
qi chantoient	qu'il cantoient (M1 N)	1
releverent de terre	releverent andoi de terre  (M1 N)	1
la	les (G1 M1 N)	1
la	lor (N)	1
vie	mortel vie (N)	1
si tres granz	granz (G1 M1 N)	1
cil qi	si com il (N)	1
disoit	lisoit (G1 M1 N)	1
acliné	enclin (N)	1
la leçon	espitre (M1 N)	1
demorance	demoree (N)	1
et 	car (M1 N)	1
einsi	çaiens (N)	1
demostré	moustré (G1 N)	1
Et	et que (M1 N)	1
cil tuit	tout cil (N)	1
noterent	volrent savoir (N)	1
beneürez	de boines oevres (N)	1
trespassement	trespasse (G1 N)	1
la mere nostre Signor Jesu Crist	la haute Dame me Dame sainte Marie (M1 N)	1
de tote chose est sires et crieres	Sires est de toute creature (G1 M1 N)	1

